# this is the text file copy and pasted from my doulingo account

un'	Determiner	6 days ago	
cinque	Numeral	6 days ago	
autorità	Noun	6 days ago	
a	Preposition	6 days ago	
questi	Determiner	6 days ago	
più	Adverb	6 days ago	
tu	Pronoun	6 days ago	
mi	Pronoun	6 days ago	
altra	Determiner	6 days ago	
non	Adverb	6 days ago	
fare	Verb	6 days ago	
avanti	Adverb	6 days ago	
si	Pronoun	6 days ago	
mia	Determiner	6 days ago	
avere	Verb	6 days ago	
in	Preposition	6 days ago	
un	Determiner	6 days ago	
come	Adverb	6 days ago	
il	Determiner	6 days ago	
stasera	Adverb	6 days ago	
che		6 days ago	
per	Preposition	6 days ago	
niente	Adverb	6 days ago	
con	Preposition	6 days ago	
queste	Determiner	6 days ago	
io	Pronoun	6 days ago	
la	Determiner	6 days ago	
situazione	Noun	6 days ago	
passo	Noun	6 days ago	
programmi	Noun	6 days ago	
passi	Noun	6 days ago	
situazioni	Noun	6 days ago	
occasione	Noun	6 days ago	
programma	Noun	6 days ago	
fenomeni	Noun	6 days ago	
sezione	Noun	6 days ago	
caso	Noun	6 days ago	
fenomeno	Noun	6 days ago	
versione	Noun	6 days ago	
loro	Pronoun	6 days ago	
lo	Determiner	6 days ago	
al	Preposition	6 days ago	
dei	Preposition	6 days ago	
giornale	Noun	6 days ago	
lui	Pronoun	6 days ago	
una	Determiner	6 days ago	
gli	Determiner	6 days ago	
lupo	Noun	6 days ago	
l'	Determiner	6 days ago	
chi	Pronoun	6 days ago	
le	Determiner	6 days ago	
quale	Pronoun	6 days ago	
lavori	Noun	6 days ago	
architetto	Noun	6 days ago	
scrittrice	Noun	6 days ago	
ricercatori	Noun	6 days ago	
operai	Noun	6 days ago	
pagliacci	Noun	6 days ago	
conduttrice	Noun	6 days ago	
scrittore	Noun	6 days ago	
ricercatrice	Noun	6 days ago	
guardie	Noun	6 days ago	
postino	Noun	6 days ago	
guardia	Noun	6 days ago	
lavoro	Noun	6 days ago	
olio	Noun	1 week ago	
quante	Pronoun	1 week ago	
sue	Determiner	1 week ago	
dove	Adverb	1 week ago	
cuoco	Noun	1 week ago	
carne	Noun	1 week ago	
tua	Determiner	1 week ago	
suo	Pronoun	1 week ago	
sì	Adverb	1 week ago	
sua	Determiner	1 week ago	
mio	Determiner	1 week ago	
i	Determiner	1 week ago	
fritto	Adjective	1 week ago	
uovo	Noun	1 week ago	
quanta	Pronoun	1 week ago	
domande	Noun	1 week ago	
domanda	Noun	1 week ago	
calze	Noun	1 week ago	
calza	Noun	1 week ago	
vestiti	Noun	1 week ago	
maglia	Noun	1 week ago	
risposta	Noun	1 week ago	
vestito	Noun	1 week ago	
nell'	Preposition	1 week ago	
ci	Pronoun	1 week ago	
suo	Determiner	1 week ago	
oggi	Adverb	1 week ago	
tre	Numeral	1 week ago	
d'	Preposition	1 week ago	
crisi	Noun	1 week ago	
e	Conjunction	1 week ago	
degli	Preposition	1 week ago	
tribunale	Noun	1 week ago	
partito	Noun	1 week ago	
arma	Noun	1 week ago	
potere	Noun	1 week ago	
esercito	Noun	1 week ago	
armi	Noun	1 week ago	
eserciti	Noun	1 week ago	
crimine	Noun	1 week ago	
accordo	Noun	1 week ago	
poteri	Noun	1 week ago	
strategia	Noun	1 week ago	
partiti	Noun	1 week ago	
imparare	Verb	1 week ago	
dignità	Noun	1 week ago	
ricordare	Verb	1 week ago	
dai	Preposition	1 week ago	
perché	Adverb	1 week ago	
comprare	Verb	1 week ago	
del	Preposition	1 week ago	
che	Conjunction	1 week ago	
povertà	Noun	1 week ago	
nella	Preposition	1 week ago	
stare	Verb	1 week ago	
questo	Determiner	1 week ago	
solo	Adverb	1 week ago	
di	Preposition	1 week ago	
rumore	Noun	1 week ago	
intelligenza	Noun	1 week ago	
viso	Noun	1 week ago	
coda	Noun	1 week ago	
visi	Noun	1 week ago	
fallimenti	Noun	1 week ago	
timore	Noun	1 week ago	
fallimento	Noun	1 week ago	
immaginazione	Noun	1 week ago	
tutta	Determiner	1 week ago	
quindici	Numeral	1 week ago	
c'	Adverb	1 week ago	
cosa	Pronoun	1 week ago	
quel	Determiner	1 week ago	
mio	Pronoun	1 week ago	
ai	Preposition	1 week ago	
fotografare	Verb	1 week ago	
me	Pronoun	1 week ago	
sempre	Adverb	1 week ago	
caffè	Noun	1 week ago	
della	Preposition	1 week ago	
qual	Adjective	1 week ago	
ballare	Verb	1 week ago	
tutti	Pronoun	1 week ago	
dal	Preposition	1 week ago	
cinema	Noun	1 week ago	
circo	Noun	1 week ago	
attrice	Noun	1 week ago	
concerto	Noun	1 week ago	
attori	Noun	1 week ago	
musica	Noun	1 week ago	
danza	Noun	1 week ago	
attore	Noun	1 week ago	
concerti	Noun	1 week ago	
stile	Noun	1 week ago	
qui	Adverb	1 week ago	
molto	Adverb	1 week ago	
labbra	Noun	1 week ago	
delle	Preposition	1 week ago	
diventare	Verb	1 week ago	
uomo	Noun	1 week ago	
gambe	Noun	1 week ago	
infermiera	Noun	1 week ago	
medico	Noun	1 week ago	
malattia	Noun	1 week ago	
ospedale	Noun	1 week ago	
gamba	Noun	1 week ago	
infermiere	Noun	1 week ago	
febbre	Noun	1 week ago	
medici	Noun	1 week ago	
farmacia	Noun	1 week ago	
gola	Noun	1 week ago	
insieme	Adverb	1 week ago	
quello	Pronoun	1 week ago	
troppo	Adverb	1 week ago	
l'	Pronoun	1 week ago	
lì	Adverb	1 week ago	
quando	Adverb	1 week ago	
quella	Determiner	1 week ago	
cane	Noun	1 week ago	
cameriere	Noun	1 week ago	
diverse	Determiner	1 week ago	
ed	Conjunction	1 week ago	
miei	Determiner	1 week ago	
donna	Noun	1 week ago	
bicchieri	Noun	1 week ago	
tuo	Determiner	1 week ago	
rispondeva	Verb	1 week ago	
suonavi	Verb	1 week ago	
azzurro	Noun	1 week ago	
seguivamo	Verb	1 week ago	
colorata	Adjective	1 week ago	
colorati	Adjective	1 week ago	
azzurri	Noun	1 week ago	
grigio	Adjective	1 week ago	
bianco	Noun	1 week ago	
seguiva	Verb	1 week ago	
seguivano	Verb	1 week ago	
suonava	Verb	1 week ago	
marrone	Adjective	1 week ago	
suonavano	Verb	1 week ago	
grigia	Adjective	1 week ago	
nulla	Pronoun	1 week ago	
meno	Adverb	1 week ago	
ognuna	Pronoun	1 week ago	
alcune	Pronoun	1 week ago	
ne	Pronoun	1 week ago	
altri	Pronoun	1 week ago	
altre	Pronoun	1 week ago	
noi	Pronoun	1 week ago	
chiunque	Pronoun	1 week ago	
alcuno	Pronoun	1 week ago	
quelle	Pronoun	1 week ago	
tutte	Pronoun	1 week ago	
così	Adverb	1 week ago	
mie	Determiner	1 week ago	
lo	Pronoun	1 week ago	
coltello	Noun	1 week ago	
bene	Adverb	1 week ago	
costa	Verb	1 week ago	
canto	Verb	1 week ago	
presta	Verb	1 week ago	
disegniamo	Verb	1 week ago	
ferisce	Verb	1 week ago	
disegna	Verb	1 week ago	
disegni	Verb	1 week ago	
cantiamo	Verb	1 week ago	
canta	Verb	1 week ago	
feriamo	Verb	1 week ago	
prestano	Verb	1 week ago	
cantano	Verb	1 week ago	
disegnano	Verb	1 week ago	
disegno	Verb	1 week ago	
lei	Pronoun	1 week ago	
zuppa	Noun	1 week ago	
biscotti	Noun	1 week ago	
gusto	Noun	1 week ago	
cioccolato	Noun	1 week ago	
funghi	Noun	1 week ago	
zoo	Noun	1 week ago	
allo	Preposition	1 week ago	
fredda	Adjective	1 week ago	
strano	Adjective	1 week ago	
sicuro	Adjective	1 week ago	
ricco	Adjective	1 week ago	
economici	Adjective	1 week ago	
ricche	Adjective	1 week ago	
freddo	Adjective	1 week ago	
corto	Adjective	1 week ago	
corte	Adjective	1 week ago	
strana	Adjective	1 week ago	
ricca	Adjective	1 week ago	
prossima	Adjective	1 week ago	
capaci	Adjective	1 week ago	
famosa	Adjective	1 week ago	
gatti	Noun	1 week ago	
sul	Preposition	1 week ago	
dov'	Adverb	1 week ago	
alla	Preposition	1 week ago	
nel	Preposition	1 week ago	
pane	Noun	1 week ago	
ragazze	Noun	1 week ago	
da	Preposition	1 week ago	
cuscini	Noun	1 week ago	
finestra	Noun	1 week ago	
riscaldamento	Noun	1 week ago	
pavimento	Noun	1 week ago	
spazzolini	Noun	1 week ago	
finestre	Noun	1 week ago	
rasoio	Noun	1 week ago	
forno	Noun	1 week ago	
vasca	Noun	1 week ago	
cuscino	Noun	1 week ago	
spazzolino	Noun	1 week ago	
letto	Noun	1 week ago	
tardi	Adverb	2 weeks ago	
questa	Determiner	2 weeks ago	
ghiaccio	Noun	2 weeks ago	
subito	Adverb	2 weeks ago	
quando		2 weeks ago	
dammi	Pronoun	2 weeks ago	
po'	Pronoun	2 weeks ago	
colazione	Noun	2 weeks ago	
nove	Numeral	2 weeks ago	
presto	Adverb	2 weeks ago	
verso	Preposition	2 weeks ago	
apri	Verb	2 weeks ago	
guarda	Verb	2 weeks ago	
aspetta	Verb	2 weeks ago	
fate	Verb	2 weeks ago	
aprite	Verb	2 weeks ago	
fa	Verb	2 weeks ago	
prendi	Verb	2 weeks ago	
arrivate	Verb	2 weeks ago	
cos'	Pronoun	2 weeks ago	
domani	Adverb	2 weeks ago	
dentro	Adverb	2 weeks ago	
quali	Pronoun	2 weeks ago	
comunità	Noun	2 weeks ago	
quanto	Pronoun	2 weeks ago	
edificio	Noun	2 weeks ago	
villaggio	Noun	2 weeks ago	
strada	Noun	2 weeks ago	
regione	Noun	2 weeks ago	
castelli	Noun	2 weeks ago	
provincia	Noun	2 weeks ago	
castello	Noun	2 weeks ago	
strade	Noun	2 weeks ago	
prigione	Noun	2 weeks ago	
regioni	Noun	2 weeks ago	
edifici	Noun	2 weeks ago	
ponte	Noun	2 weeks ago	
patata	Noun	2 weeks ago	
caramella	Noun	2 weeks ago	
pasto	Noun	2 weeks ago	
aglio	Noun	2 weeks ago	
pranza	Verb	2 weeks ago	
uva	Noun	2 weeks ago	
vostri	Determiner	2 weeks ago	
vino	Noun	2 weeks ago	
lana	Noun	2 weeks ago	
orologio	Noun	2 weeks ago	
orologi	Noun	2 weeks ago	
autobus	Noun	2 weeks ago	
gli	Pronoun	2 weeks ago	
neanche	Adverb	2 weeks ago	
ad	Preposition	2 weeks ago	
andare	Verb	2 weeks ago	
già	Adverb	2 weeks ago	
dieci	Numeral	2 weeks ago	
questo	Pronoun	2 weeks ago	
dell'	Preposition	2 weeks ago	
disse	Verb	2 weeks ago	
mise	Verb	2 weeks ago	
portai	Verb	2 weeks ago	
trovarono	Verb	2 weeks ago	
seppero	Verb	2 weeks ago	
fu	Verb	2 weeks ago	
volle	Verb	2 weeks ago	
credettero	Verb	2 weeks ago	
successe	Verb	2 weeks ago	
portò	Verb	2 weeks ago	
trovai	Verb	2 weeks ago	
sapeste	Verb	2 weeks ago	
fummo	Verb	2 weeks ago	
trovammo	Verb	2 weeks ago	
seppe	Verb	2 weeks ago	
dissi	Verb	2 weeks ago	
foste	Verb	2 weeks ago	
vollero	Verb	2 weeks ago	
credemmo	Verb	2 weeks ago	
dopo	Preposition	2 weeks ago	
chiamò	Verb	2 weeks ago	
ancora	Adverb	2 weeks ago	
verità	Noun	2 weeks ago	
provassimo	Verb	2 weeks ago	
ricordassi	Verb	2 weeks ago	
usasse	Verb	2 weeks ago	
seguisse	Verb	2 weeks ago	
provasse	Verb	2 weeks ago	
suonasse	Verb	2 weeks ago	
vivesse	Verb	2 weeks ago	
morisse	Verb	2 weeks ago	
dicessimo	Verb	2 weeks ago	
provassi	Verb	2 weeks ago	
avesse	Verb	2 weeks ago	
grazie	Interjection	2 weeks ago	
radio	Noun	2 weeks ago	
questa	Pronoun	2 weeks ago	
essenzialmente	Adverb	2 weeks ago	
sulla	Preposition	2 weeks ago	
uno	Determiner	2 weeks ago	
francobollo	Noun	2 weeks ago	
giornalista	Noun	2 weeks ago	
francobolli	Noun	2 weeks ago	
informazioni	Noun	2 weeks ago	
chiamata	Noun	2 weeks ago	
canale	Noun	2 weeks ago	
rivista	Noun	2 weeks ago	
riviste	Noun	2 weeks ago	
lettore	Noun	2 weeks ago	
giornalisti	Noun	2 weeks ago	
informazione	Noun	2 weeks ago	
ora	Adverb	2 weeks ago	
tutti	Determiner	2 weeks ago	
qualche	Determiner	2 weeks ago	
costruire	Verb	2 weeks ago	
finanza	Noun	2 weeks ago	
servizio	Noun	2 weeks ago	
consigli	Noun	2 weeks ago	
costo	Noun	2 weeks ago	
consiglio	Noun	2 weeks ago	
costi	Noun	2 weeks ago	
stipendi	Noun	2 weeks ago	
servizi	Noun	2 weeks ago	
banca	Noun	2 weeks ago	
produzione	Noun	2 weeks ago	
stipendio	Noun	2 weeks ago	
dire	Verb	2 weeks ago	
dove		2 weeks ago	
mai	Adverb	2 weeks ago	
le	Pronoun	2 weeks ago	
davvero	Adverb	2 weeks ago	
qualcosa	Pronoun	2 weeks ago	
piuttosto	Adverb	2 weeks ago	
ventosa	Adjective	2 weeks ago	
lago	Noun	2 weeks ago	
legno	Noun	2 weeks ago	
natura	Noun	2 weeks ago	
campagna	Noun	2 weeks ago	
ventoso	Adjective	2 weeks ago	
pianeta	Noun	2 weeks ago	
neve	Noun	2 weeks ago	
sole	Noun	2 weeks ago	
pietra	Noun	2 weeks ago	
laghi	Noun	2 weeks ago	
te	Pronoun	2 weeks ago	
vedere	Verb	2 weeks ago	
ti	Pronoun	2 weeks ago	
poi	Adverb	2 weeks ago	
tutto	Pronoun	2 weeks ago	
qualsiasi	Determiner	2 weeks ago	
qua	Adverb	2 weeks ago	
gravità	Noun	2 weeks ago	
giù	Adverb	2 weeks ago	
soltanto	Adverb	2 weeks ago	
elementi	Noun	2 weeks ago	
matematica	Noun	2 weeks ago	
conoscenza	Noun	2 weeks ago	
invenzione	Noun	2 weeks ago	
elemento	Noun	2 weeks ago	
energia	Noun	2 weeks ago	
modo	Noun	2 weeks ago	
invenzioni	Noun	2 weeks ago	
chimica	Noun	2 weeks ago	
temperatura	Noun	2 weeks ago	
sopra	Adverb	2 weeks ago	
accendere	Verb	2 weeks ago	
volare	Verb	2 weeks ago	
sedere	Verb	2 weeks ago	
crescere	Verb	2 weeks ago	
scusare	Verb	2 weeks ago	
anche	Adverb	2 weeks ago	
spiegare	Verb	2 weeks ago	
coltivare	Verb	2 weeks ago	
disegnare	Verb	2 weeks ago	
animali	Noun	2 weeks ago	
fermare	Verb	2 weeks ago	
gatto	Noun	2 weeks ago	
animale	Noun	2 weeks ago	
quanti	Pronoun	2 weeks ago	
simpatico	Adjective	2 weeks ago	
simpatici	Adjective	2 weeks ago	
adulti	Noun	2 weeks ago	
gente	Noun	2 weeks ago	
rapporto	Noun	2 weeks ago	
popolazione	Noun	2 weeks ago	
sposi	Noun	2 weeks ago	
adulto	Noun	2 weeks ago	
sposa	Noun	2 weeks ago	
popoli	Noun	2 weeks ago	
popolo	Noun	2 weeks ago	
rapporti	Noun	2 weeks ago	
amica	Noun	2 weeks ago	
amico	Noun	2 weeks ago	
amici	Noun	2 weeks ago	
tua	Pronoun	2 weeks ago	
giocare	Verb	2 weeks ago	
acqua	Noun	2 weeks ago	
nuotare	Verb	2 weeks ago	
quattro	Numeral	2 weeks ago	
alle	Preposition	2 weeks ago	
cani	Noun	2 weeks ago	
saltare	Verb	2 weeks ago	
passeggiata	Noun	2 weeks ago	
biciclette	Noun	2 weeks ago	
bici	Noun	2 weeks ago	
premio	Noun	2 weeks ago	
atleti	Noun	2 weeks ago	
calcio	Noun	2 weeks ago	
bicicletta	Noun	2 weeks ago	
palla	Noun	2 weeks ago	
premi	Noun	2 weeks ago	
atleta	Noun	2 weeks ago	
sette	Numeral	3 weeks ago	
latte	Noun	3 weeks ago	
appena	Adverb	3 weeks ago	
alcol	Noun	3 weeks ago	
paio	Noun	3 weeks ago	
nostro	Determiner	3 weeks ago	
ventilatori	Noun	3 weeks ago	
batteria	Noun	3 weeks ago	
schermo	Noun	3 weeks ago	
flauto	Noun	3 weeks ago	
oggetto	Noun	3 weeks ago	
oggetti	Noun	3 weeks ago	
ventilatore	Noun	3 weeks ago	
diario	Noun	3 weeks ago	
busta	Noun	3 weeks ago	
patente	Noun	3 weeks ago	
verdura	Noun	3 weeks ago	
tè	Noun	3 weeks ago	
birra	Noun	3 weeks ago	
finché	Conjunction	3 weeks ago	
oppure	Conjunction	3 weeks ago	
bensì	Conjunction	3 weeks ago	
sia	Conjunction	3 weeks ago	
mentre	Conjunction	3 weeks ago	
né	Conjunction	3 weeks ago	
scrivania	Noun	3 weeks ago	
sapone	Noun	3 weeks ago	
tuo	Pronoun	3 weeks ago	
piatti	Noun	3 weeks ago	
forse	Adverb	3 weeks ago	
tue	Determiner	3 weeks ago	
amichevole	Adjective	3 weeks ago	
furbo	Adjective	3 weeks ago	
furba	Adjective	3 weeks ago	
impegnata	Adjective	3 weeks ago	
furbi	Adjective	3 weeks ago	
corretta	Adjective	3 weeks ago	
grasso	Adjective	3 weeks ago	
furbe	Adjective	3 weeks ago	
crescente	Adjective	3 weeks ago	
impegnato	Adjective	3 weeks ago	
formali	Adjective	3 weeks ago	
formale	Adjective	3 weeks ago	
sporche	Adjective	3 weeks ago	
sporchi	Adjective	3 weeks ago	
amichevoli	Adjective	3 weeks ago	
preferita	Adjective	3 weeks ago	
aspettare	Verb	3 weeks ago	
mangiare	Verb	3 weeks ago	
vivere	Verb	3 weeks ago	
voler	Verb	3 weeks ago	
essere	Verb	3 weeks ago	
aggiungere	Verb	3 weeks ago	
succedere	Verb	3 weeks ago	
camminare	Verb	3 weeks ago	
poter	Verb	3 weeks ago	
no	Adverb	3 weeks ago	
vorrò	Verb	3 weeks ago	
dovrà	Verb	3 weeks ago	
dovremo	Verb	3 weeks ago	
vorranno	Verb	3 weeks ago	
potevo	Verb	3 weeks ago	
dovrei	Verb	3 weeks ago	
poteva	Verb	3 weeks ago	
dovrebbe	Verb	3 weeks ago	
devo	Verb	3 weeks ago	
dovrò	Verb	3 weeks ago	
dobbiamo	Verb	3 weeks ago	
doveva	Verb	3 weeks ago	
dovrai	Verb	3 weeks ago	
devi	Verb	3 weeks ago	
devono	Verb	3 weeks ago	
deve	Verb	3 weeks ago	
potevano	Verb	3 weeks ago	
invece	Adverb	4 weeks ago	
generalmente	Adverb	4 weeks ago	
recentemente	Adverb	4 weeks ago	
quelle	Determiner	4 weeks ago	
neppure	Adverb	4 weeks ago	
due	Numeral	4 weeks ago	
neanch'	Adverb	4 weeks ago	
ben	Adverb	4 weeks ago	
anzi	Adverb	4 weeks ago	
gravemente	Adverb	4 weeks ago	
semplicemente	Adverb	4 weeks ago	
america	Proper noun	4 weeks ago	
metà	Noun	4 weeks ago	
sull'	Preposition	4 weeks ago	
passeggeri	Noun	4 weeks ago	
traffico	Noun	4 weeks ago	
francesi	Noun	4 weeks ago	
biglietto	Noun	4 weeks ago	
turisti	Noun	4 weeks ago	
campeggi	Noun	4 weeks ago	
americano	Adjective	4 weeks ago	
americana	Adjective	4 weeks ago	
italiana	Noun	4 weeks ago	
americani	Adjective	4 weeks ago	
italiani	Noun	4 weeks ago	
americane	Adjective	4 weeks ago	
biglietti	Noun	4 weeks ago	
italiano	Noun	4 weeks ago	
possibilità	Noun	4 weeks ago	
certo	Adverb	4 weeks ago	
decida	Verb	4 weeks ago	
suonino	Verb	4 weeks ago	
prenda	Verb	4 weeks ago	
passino	Verb	4 weeks ago	
passi	Verb	4 weeks ago	
arrivino	Verb	4 weeks ago	
cambi	Verb	4 weeks ago	
indichiate	Verb	4 weeks ago	
arrivi	Verb	4 weeks ago	
suoni	Verb	4 weeks ago	
succeda	Verb	4 weeks ago	
fuori	Adverb	4 weeks ago	
la	Pronoun	4 weeks ago	
scrivere	Verb	4 weeks ago	
venire	Verb	4 weeks ago	
cambierebbe	Verb	4 weeks ago	
potremmo	Verb	4 weeks ago	
parlerebbe	Verb	4 weeks ago	
saprei	Verb	4 weeks ago	
proverebbe	Verb	4 weeks ago	
potrebbe	Verb	4 weeks ago	
terrebbe	Verb	4 weeks ago	
crederebbero	Verb	4 weeks ago	
crederebbe	Verb	4 weeks ago	
perderebbe	Verb	4 weeks ago	
saprebbe	Verb	4 weeks ago	
proveremmo	Verb	4 weeks ago	
vivrebbe	Verb	4 weeks ago	
parlerei	Verb	4 weeks ago	
cambieresti	Verb	4 weeks ago	
perderemmo	Verb	4 weeks ago	
terrei	Verb	4 weeks ago	
gelato	Noun	4 weeks ago	
professionale	Adjective	4 weeks ago	
storica	Adjective	4 weeks ago	
superiore	Adjective	4 weeks ago	
particolare	Adjective	4 weeks ago	
superiori	Adjective	4 weeks ago	
statale	Adjective	4 weeks ago	
provinciale	Adjective	4 weeks ago	
familiare	Adjective	4 weeks ago	
storico	Adjective	4 weeks ago	
definitiva	Adjective	4 weeks ago	
particolari	Adjective	4 weeks ago	
industriale	Adjective	4 weeks ago	
cena	Noun	4 weeks ago	
quaranta	Numeral	4 weeks ago	
quarant'	Numeral	4 weeks ago	
diciotto	Numeral	4 weeks ago	
otto	Numeral	4 weeks ago	
spagna	Proper noun	4 weeks ago	
circa	Adverb	4 weeks ago	
cavalli	Noun	4 weeks ago	
cento	Numeral	4 weeks ago	
all'	Preposition	4 weeks ago	
forchette	Noun	4 weeks ago	
diciannove	Numeral	4 weeks ago	
dodici	Numeral	4 weeks ago	
milione	Noun	4 weeks ago	
decimo	Adjective	4 weeks ago	
decima	Adjective	4 weeks ago	
milioni	Noun	4 weeks ago	
stamattina	Adverb	4 weeks ago	
griglia	Noun	4 weeks ago	
venerdì	Noun	4 weeks ago	
mercoledì	Noun	4 weeks ago	
pollo	Noun	4 weeks ago	
lunedì	Noun	4 weeks ago	
gennaio	Noun	4 weeks ago	
data	Noun	4 weeks ago	
sabato	Noun	4 weeks ago	
giorni	Noun	4 weeks ago	
giorno	Noun	4 weeks ago	
agosto	Noun	4 weeks ago	
compleanno	Noun	4 weeks ago	
estate	Noun	4 weeks ago	
date	Noun	4 weeks ago	
se	Conjunction	1 month ago	
insetti	Noun	1 month ago	
mangiando	Verb	1 month ago	
perdendo	Verb	1 month ago	
andando	Verb	1 month ago	
riso	Noun	1 month ago	
voi	Pronoun	1 month ago	
dando	Verb	1 month ago	
aspettando	Verb	1 month ago	
morendo	Verb	1 month ago	
offrendo	Verb	1 month ago	
lavorando	Verb	1 month ago	
toccando	Verb	1 month ago	
velocità	Noun	1 month ago	
oltre	Adverb	1 month ago	
durata	Noun	1 month ago	
radice	Noun	1 month ago	
arrivo	Noun	1 month ago	
interpretazione	Noun	1 month ago	
onore	Noun	1 month ago	
segnale	Noun	1 month ago	
radici	Noun	1 month ago	
importanza	Noun	1 month ago	
partenza	Noun	1 month ago	
arrivi	Noun	1 month ago	
piatto	Noun	1 month ago	
nostre	Pronoun	1 month ago	
proprio	Determiner	1 month ago	
nostri	Determiner	1 month ago	
banane	Noun	1 month ago	
tue	Pronoun	1 month ago	
nostro	Pronoun	1 month ago	
vostre	Determiner	1 month ago	
spiacente	Adjective	1 month ago	
torte	Noun	1 month ago	
bottiglie	Noun	1 month ago	
bevanda	Noun	1 month ago	
ragazza	Noun	1 month ago	
sua	Pronoun	1 month ago	
votare	Verb	1 month ago	
troppa	Determiner	1 month ago	
leggi	Noun	1 month ago	
senatrice	Noun	1 month ago	
senatori	Noun	1 month ago	
negoziazioni	Noun	1 month ago	
legge	Noun	1 month ago	
corruzione	Noun	1 month ago	
negoziazione	Noun	1 month ago	
colonnelli	Noun	1 month ago	
senatore	Noun	1 month ago	
politica	Noun	1 month ago	
presidente	Noun	1 month ago	
elezioni	Noun	1 month ago	
odiare	Verb	1 month ago	
abbastanza	Adverb	1 month ago	
cavallo	Noun	1 month ago	
spaventare	Verb	1 month ago	
coraggio	Noun	1 month ago	
fortuna	Noun	1 month ago	
sorprese	Adjective	1 month ago	
bisogno	Noun	1 month ago	
amore	Noun	1 month ago	
divertimento	Noun	1 month ago	
divertimenti	Noun	1 month ago	
sorpresa	Adjective	1 month ago	
triste	Adjective	1 month ago	
uomini	Noun	1 month ago	
cibo	Noun	1 month ago	
guido	Verb	1 month ago	
cambiano	Verb	1 month ago	
basta	Verb	1 month ago	
cerca	Verb	1 month ago	
cadono	Verb	1 month ago	
cambio	Verb	1 month ago	
chiude	Verb	1 month ago	
guida	Verb	1 month ago	
chiudi	Verb	1 month ago	
unisce	Verb	1 month ago	
paga	Verb	1 month ago	
provo	Verb	1 month ago	
nei	Preposition	1 month ago	
affittare	Verb	1 month ago	
abbassare	Verb	1 month ago	
prezzi	Noun	1 month ago	
economia	Noun	1 month ago	
industria	Noun	1 month ago	
credito	Noun	1 month ago	
documenti	Noun	1 month ago	
uffici	Noun	1 month ago	
ufficio	Noun	1 month ago	
pagamenti	Noun	1 month ago	
offerta	Noun	1 month ago	
dall'	Preposition	1 month ago	
iniziare	Verb	1 month ago	
nessuna	Determiner	1 month ago	
vicino	Adverb	1 month ago	
cominciare	Verb	1 month ago	
dimmi	Pronoun	1 month ago	
lati	Noun	1 month ago	
ingresso	Noun	1 month ago	
parte	Noun	1 month ago	
lato	Noun	1 month ago	
cima	Noun	1 month ago	
fine	Noun	1 month ago	
destra	Noun	1 month ago	
via	Adverb	1 month ago	
troppo	Determiner	1 month ago	
cucchiaio	Noun	1 month ago	
sentiranno	Verb	1 month ago	
dirò	Verb	1 month ago	
userai	Verb	1 month ago	
sentirai	Verb	1 month ago	
entrerà	Verb	1 month ago	
parlerò	Verb	1 month ago	
suonerò	Verb	1 month ago	
andrai	Verb	1 month ago	
conoscerete	Verb	1 month ago	
sentirò	Verb	1 month ago	
passerai	Verb	1 month ago	
società	Noun	1 month ago	
capacità	Noun	1 month ago	
altro	Determiner	1 month ago	
loro	Determiner	1 month ago	
risultati	Noun	1 month ago	
differenza	Noun	1 month ago	
motivo	Noun	1 month ago	
piano	Noun	1 month ago	
differenze	Noun	1 month ago	
motivi	Noun	1 month ago	
conseguenze	Noun	1 month ago	
vittime	Noun	1 month ago	
risultato	Noun	1 month ago	
favore	Noun	1 month ago	
miei	Pronoun	1 month ago	
scimmia	Noun	1 month ago	
propri	Determiner	1 month ago	
torta	Noun	1 month ago	
limone	Noun	1 month ago	
pepe	Noun	1 month ago	
nostra	Pronoun	1 month ago	
ragazzo	Noun	1 month ago	
propria	Determiner	1 month ago	
ape	Noun	1 month ago	
marmellata	Noun	1 month ago	
taglio	Verb	1 month ago	
acido	Adjective	1 month ago	
arancia	Noun	1 month ago	
pranzano	Verb	1 month ago	
fragola	Noun	1 month ago	
tacchino	Noun	1 month ago	
ristorante	Noun	1 month ago	
donne	Noun	1 month ago	
menu	Noun	1 month ago	
cena	Verb	1 month ago	
fame	Noun	1 month ago	
panino	Noun	1 month ago	
insalata	Noun	1 month ago	
vostro	Determiner	1 month ago	
ciao	Interjection	1 month ago	
ma	Conjunction	1 month ago	
o	Conjunction	1 month ago	
zia	Noun	1 month ago	
zio	Noun	1 month ago	
madre	Noun	1 month ago	
nonno	Noun	1 month ago	
padre	Noun	1 month ago	
zie	Noun	1 month ago	
moglie	Noun	1 month ago	
nipote	Noun	1 month ago	
cognome	Noun	1 month ago	
sorella	Noun	1 month ago	
marito	Noun	1 month ago	
sorelle	Noun	1 month ago	
elefante	Noun	1 month ago	
delfino	Noun	1 month ago	
pesce	Noun	1 month ago	
balena	Noun	1 month ago	
maiale	Noun	1 month ago	
toro	Noun	1 month ago	
ceniamo	Verb	1 month ago	
mela	Noun	1 month ago	
limonata	Noun	1 month ago	
mucche	Noun	1 month ago	
zucchero	Noun	1 month ago	
formica	Noun	1 month ago	
squalo	Noun	1 month ago	
farfalla	Noun	1 month ago	
panini	Noun	1 month ago	
mucca	Noun	1 month ago	
ragno	Noun	1 month ago	
pensando	Verb	1 month ago	
intorno	Adverb	1 month ago	
prendeva	Verb	1 month ago	
lasciava	Verb	1 month ago	
lasciavano	Verb	1 month ago	
succedeva	Verb	1 month ago	
pensavi	Verb	1 month ago	
usavamo	Verb	1 month ago	
offriva	Verb	1 month ago	
portava	Verb	1 month ago	
pensavo	Verb	1 month ago	
indicava	Verb	1 month ago	
università	Noun	1 month ago	
paragrafo	Noun	1 month ago	
istituzione	Noun	1 month ago	
esempi	Noun	1 month ago	
classe	Noun	1 month ago	
capitolo	Noun	1 month ago	
paragrafi	Noun	1 month ago	
capitoli	Noun	1 month ago	
lingue	Noun	1 month ago	
istituzioni	Noun	1 month ago	
biblioteca	Noun	1 month ago	
lingua	Noun	1 month ago	
titolo	Noun	1 month ago	
esempio	Noun	1 month ago	
virus	Noun	1 month ago	
dieta	Noun	1 month ago	
mani	Noun	1 month ago	
voci	Noun	1 month ago	
pazienti	Noun	1 month ago	
bocca	Noun	1 month ago	
voce	Noun	1 month ago	
nascita	Noun	1 month ago	
incidente	Noun	1 month ago	
mano	Noun	1 month ago	
collo	Noun	1 month ago	
bottiglia	Noun	1 month ago	
età	Noun	1 month ago	
sotto	Adverb	1 month ago	
svuoto	Verb	1 month ago	
parcheggiano	Verb	1 month ago	
rompe	Verb	1 month ago	
mento	Verb	1 month ago	
esploriamo	Verb	1 month ago	
asciugo	Verb	1 month ago	
suppongo	Verb	1 month ago	
supponiamo	Verb	1 month ago	
esplorate	Verb	1 month ago	
mente	Verb	1 month ago	
sembra	Verb	1 month ago	
dispiace	Verb	1 month ago	
parcheggi	Verb	1 month ago	
rompono	Verb	1 month ago	
soli	Adjective	1 month ago	
brava	Adjective	1 month ago	
impossibile	Adjective	1 month ago	
sola	Adjective	1 month ago	
bassa	Adjective	1 month ago	
breve	Adjective	1 month ago	
vero	Adjective	1 month ago	
speciale	Adjective	1 month ago	
speciali	Adjective	1 month ago	
interessata	Adjective	1 month ago	
libera	Adjective	1 month ago	
basso	Adjective	1 month ago	
interessato	Adjective	1 month ago	
polli	Noun	1 month ago	
gatte	Noun	1 month ago	
fagiolo	Noun	1 month ago	
bolle	Verb	1 month ago	
elefanti	Noun	1 month ago	
forchetta	Noun	1 month ago	
crema	Noun	1 month ago	
buonanotte	Interjection	1 month ago	
frutta	Noun	1 month ago	
taglia	Verb	1 month ago	
arrivederci	Interjection	1 month ago	
prego	Interjection	1 month ago	
buonasera	Interjection	1 month ago	
formaggio	Noun	1 month ago	
buongiorno	Interjection	1 month ago	
realtà	Noun	1 month ago	
virtù	Noun	1 month ago	
celebrazione	Noun	1 month ago	
destino	Noun	1 month ago	
religione	Noun	1 month ago	
santa	Adjective	1 month ago	
depressione	Noun	1 month ago	
cattedrale	Noun	1 month ago	
esistenza	Noun	1 month ago	
adesso	Adverb	1 month ago	
temporali	Noun	1 month ago	
nuvola	Noun	1 month ago	
vento	Noun	1 month ago	
nuvole	Noun	1 month ago	
venti	Noun	1 month ago	
erba	Noun	1 month ago	
fumi	Noun	1 month ago	
temporale	Noun	1 month ago	
paesaggio	Noun	1 month ago	
spiaggia	Noun	1 month ago	
mare	Noun	1 month ago	
cielo	Noun	1 month ago	
diventando	Verb	1 month ago	
stato	Noun	1 month ago	
sistema	Noun	1 month ago	
governatrice	Noun	1 month ago	
arresto	Noun	1 month ago	
sistemi	Noun	1 month ago	
governatore	Noun	1 month ago	
battaglia	Noun	1 month ago	
stati	Noun	1 month ago	
diplomazia	Noun	1 month ago	
guerra	Noun	1 month ago	
resistenza	Noun	1 month ago	
guardando	Verb	1 month ago	
se	Pronoun	1 month ago	
poco	Adverb	1 month ago	
inviare	Verb	1 month ago	
tra	Preposition	1 month ago	
telefonare	Verb	1 month ago	
televisione	Noun	1 month ago	
stampa	Noun	1 month ago	
opinione	Noun	1 month ago	
opinioni	Noun	1 month ago	
dialoghi	Noun	1 month ago	
conversazione	Noun	1 month ago	
comunicazione	Noun	1 month ago	
conversazioni	Noun	1 month ago	
sue	Pronoun	1 month ago	
alcuni	Pronoun	1 month ago	
specialmente	Adverb	1 month ago	
tamburi	Noun	1 month ago	
fotografia	Noun	1 month ago	
mostra	Noun	1 month ago	
chitarra	Noun	1 month ago	
tamburo	Noun	1 month ago	
palco	Noun	1 month ago	
palchi	Noun	1 month ago	
architettura	Noun	1 month ago	
poesia	Noun	1 month ago	
spettacolo	Noun	1 month ago	
poesie	Noun	1 month ago	
fama	Noun	1 month ago	
fotografie	Noun	1 month ago	
costare	Verb	1 month ago	
perché	Conjunction	1 month ago	
andarci	Pronoun	1 month ago	
insegnare	Verb	1 month ago	
glielo	Pronoun	1 month ago	
attraversare	Verb	1 month ago	
salvare	Verb	1 month ago	
passarti	Pronoun	1 month ago	
tanto	Adverb	1 month ago	
vendere	Verb	1 month ago	
controllare	Verb	1 month ago	
bistecca	Noun	1 month ago	
caramelle	Noun	1 month ago	
mettete	Verb	1 month ago	
danno	Verb	1 month ago	
chiedo	Verb	1 month ago	
dà	Verb	1 month ago	
metto	Verb	1 month ago	
dicono	Verb	1 month ago	
vedo	Verb	1 month ago	
vede	Verb	1 month ago	
vivono	Verb	1 month ago	
decidi	Verb	1 month ago	
tuoi	Pronoun	1 month ago	
suoi	Determiner	1 month ago	
nello	Preposition	1 month ago	
serpente	Noun	1 month ago	
abbigliamento	Noun	1 month ago	
giacca	Noun	1 month ago	
tasca	Noun	1 month ago	
stivale	Noun	1 month ago	
guanto	Noun	1 month ago	
abito	Noun	1 month ago	
gioielleria	Noun	1 month ago	
borsa	Noun	1 month ago	
maglioni	Noun	1 month ago	
guanti	Noun	1 month ago	
abiti	Noun	1 month ago	
tasche	Noun	1 month ago	
borse	Noun	1 month ago	
fa	Adverb	1 month ago	
tutto	Determiner	1 month ago	
coscienza	Noun	1 month ago	
chiese	Noun	1 month ago	
moschea	Noun	1 month ago	
scriviamo	Verb	1 month ago	
scrivete	Verb	1 month ago	
bevete	Verb	1 month ago	
siamo	Verb	1 month ago	
beviamo	Verb	1 month ago	
leggi	Verb	1 month ago	
leggo	Verb	1 month ago	
scrive	Verb	1 month ago	
ho	Verb	1 month ago	
facessi	Verb	1 month ago	
volessi	Verb	1 month ago	
sentisse	Verb	1 month ago	
unisse	Verb	1 month ago	
tenesse	Verb	1 month ago	
chiedesse	Verb	1 month ago	
parlassi	Verb	1 month ago	
passasse	Verb	1 month ago	
tuoi	Determiner	1 month ago	
vincere	Verb	1 month ago	
ogni	Determiner	1 month ago	
proposte	Noun	1 month ago	
interesse	Noun	1 month ago	
proposta	Noun	1 month ago	
commercio	Noun	1 month ago	
interessi	Noun	1 month ago	
denaro	Noun	1 month ago	
incontri	Noun	1 month ago	
incontro	Noun	1 month ago	
finanziamenti	Noun	1 month ago	
ditta	Noun	1 month ago	
completamente	Adverb	1 month ago	
proprio	Adverb	1 month ago	
presto	Adjective	1 month ago	
fortunata	Adjective	1 month ago	
selvaggi	Adjective	1 month ago	
annoiato	Adjective	1 month ago	
radicali	Adjective	1 month ago	
terribile	Adjective	1 month ago	
radicale	Adjective	1 month ago	
annoiata	Adjective	1 month ago	
fortunati	Adjective	1 month ago	
ideale	Adjective	1 month ago	
brillante	Adjective	1 month ago	
comodo	Adjective	1 month ago	
quanto		1 month ago	
prendere	Verb	1 month ago	
viva	Adjective	1 month ago	
vivo	Adjective	1 month ago	
alberi	Noun	1 month ago	
aria	Noun	1 month ago	
alba	Noun	1 month ago	
stella	Noun	1 month ago	
foresta	Noun	1 month ago	
giardino	Noun	1 month ago	
albero	Noun	1 month ago	
stelle	Noun	1 month ago	
pioggia	Noun	1 month ago	
senza	Preposition	1 month ago	
dopo	Adverb	1 month ago	
meglio	Adverb	1 month ago	
quell'	Determiner	1 month ago	
qualcos'	Pronoun	1 month ago	
altro	Pronoun	1 month ago	
troverebbe	Verb	1 month ago	
conoscerebbe	Verb	1 month ago	
metterebbe	Verb	1 month ago	
vorrebbe	Verb	1 month ago	
indicherei	Verb	1 month ago	
conoscerei	Verb	1 month ago	
metterei	Verb	1 month ago	
porterei	Verb	1 month ago	
prenderebbe	Verb	1 month ago	
offrirei	Verb	1 month ago	
scriverebbero	Verb	1 month ago	
scriverei	Verb	1 month ago	
porteresti	Verb	1 month ago	
ridere	Verb	1 month ago	
ovunque	Adverb	1 month ago	
passeremmo	Verb	1 month ago	
lascerebbe	Verb	1 month ago	
giocherebbe	Verb	1 month ago	
aprireste	Verb	1 month ago	
aspetterei	Verb	1 month ago	
seguirebbe	Verb	1 month ago	
passerebbe	Verb	1 month ago	
succederebbe	Verb	1 month ago	
morirebbe	Verb	1 month ago	
risponderebbero	Verb	1 month ago	
significare	Verb	1 month ago	
elettricità	Noun	1 month ago	
definizione	Noun	1 month ago	
filosofie	Noun	1 month ago	
metalli	Noun	1 month ago	
metallo	Noun	1 month ago	
filosofia	Noun	1 month ago	
tecnici	Noun	1 month ago	
meccanismo	Noun	1 month ago	
evoluzione	Noun	1 month ago	
qualcuno	Pronoun	1 month ago	
sapere	Verb	1 month ago	
pranzo	Noun	1 month ago	
voglia	Verb	1 month ago	
trovi	Verb	1 month ago	
sentano	Verb	1 month ago	
aspettino	Verb	1 month ago	
vogliano	Verb	1 month ago	
aspetti	Verb	1 month ago	
risponda	Verb	1 month ago	
abbiano	Verb	1 month ago	
chieda	Verb	1 month ago	
offra	Verb	1 month ago	
senta	Verb	1 month ago	
noleggiare	Verb	1 month ago	
asia	Proper noun	1 month ago	
viaggio	Noun	1 month ago	
tedesco	Adjective	1 month ago	
tedeschi	Adjective	1 month ago	
viaggi	Noun	1 month ago	
pilota	Noun	1 month ago	
visita	Noun	1 month ago	
valigia	Noun	1 month ago	
destinazione	Noun	1 month ago	
barca	Noun	1 month ago	
tedesche	Adjective	1 month ago	
tedesca	Adjective	1 month ago	
aereo	Noun	1 month ago	
seguiate	Verb	1 month ago	
possa	Verb	1 month ago	
lavori	Verb	1 month ago	
guardino	Verb	1 month ago	
perda	Verb	1 month ago	
apra	Verb	1 month ago	
lasci	Verb	1 month ago	
segua	Verb	1 month ago	
guardi	Verb	1 month ago	
fumare	Verb	1 month ago	
dormire	Verb	1 month ago	
finire	Verb	1 month ago	
successi	Noun	1 month ago	
guai	Noun	1 month ago	
successo	Noun	1 month ago	
eguaglianza	Noun	1 month ago	
causa	Noun	1 month ago	
cause	Noun	1 month ago	
caduta	Noun	1 month ago	
indipendenza	Noun	1 month ago	
abitudine	Noun	1 month ago	
ricchezza	Noun	1 month ago	
delitti	Noun	1 month ago	
uno	Pronoun	1 month ago	
dettagli	Noun	1 month ago	
perdita	Noun	1 month ago	
infanzia	Noun	1 month ago	
silenzio	Noun	1 month ago	
ritmi	Noun	1 month ago	
ritmo	Noun	1 month ago	
intenzione	Noun	1 month ago	
elenco	Noun	1 month ago	
rappresentanti	Noun	1 month ago	
rappresentante	Noun	1 month ago	
sorpresa	Noun	1 month ago	
tutte	Determiner	1 month ago	
palcoscenico	Noun	1 month ago	
ballo	Noun	1 month ago	
moda	Noun	1 month ago	
scena	Noun	1 month ago	
galleria	Noun	1 month ago	
gallerie	Noun	1 month ago	
poeta	Noun	1 month ago	
film	Noun	1 month ago	
pittore	Noun	1 month ago	
balli	Noun	1 month ago	
finendo	Verb	1 month ago	
mentire	Verb	1 month ago	
insetto	Noun	1 month ago	
volendo	Verb	1 month ago	
giocando	Verb	1 month ago	
chiedendo	Verb	1 month ago	
camminando	Verb	1 month ago	
sapendo	Verb	1 month ago	
prendendo	Verb	1 month ago	
portando	Verb	1 month ago	
entrando	Verb	1 month ago	
saremo	Verb	1 month ago	
lavoreranno	Verb	1 month ago	
sarai	Verb	1 month ago	
sarete	Verb	1 month ago	
saranno	Verb	1 month ago	
troverete	Verb	1 month ago	
metterai	Verb	1 month ago	
lavoreremo	Verb	1 month ago	
troverà	Verb	1 month ago	
partirà	Verb	1 month ago	
partiremo	Verb	1 month ago	
rimarranno	Verb	1 month ago	
partirò	Verb	1 month ago	
lavorerò	Verb	1 month ago	
sarò	Verb	1 month ago	
leggeranno	Verb	1 month ago	
leggerò	Verb	1 month ago	
partirai	Verb	1 month ago	
sarà	Verb	1 month ago	
leggerà	Verb	1 month ago	
diagnosi	Noun	1 month ago	
dita	Noun	1 month ago	
quella	Pronoun	1 month ago	
trattamento	Noun	1 month ago	
spalla	Noun	1 month ago	
pelle	Noun	1 month ago	
orecchio	Noun	1 month ago	
spalle	Noun	1 month ago	
schiena	Noun	1 month ago	
piede	Noun	1 month ago	
capelli	Noun	1 month ago	
orecchi	Noun	1 month ago	
piedi	Noun	1 month ago	
carota	Noun	1 month ago	
particolarmente	Adverb	1 month ago	
probabilmente	Adverb	1 month ago	
raramente	Adverb	1 month ago	
guidare	Verb	1 month ago	
quindi	Adverb	1 month ago	
certamente	Adverb	1 month ago	
perfettamente	Adverb	1 month ago	
frequentemente	Adverb	1 month ago	
ugualmente	Adverb	1 month ago	
eppure	Adverb	1 month ago	
pasta	Noun	1 month ago	
dello	Preposition	1 month ago	
piacere	Verb	1 month ago	
passiamola	Pronoun	1 month ago	
arrivare	Verb	1 month ago	
burro	Noun	1 month ago	
chiama	Verb	1 month ago	
stai	Verb	1 month ago	
metti	Verb	1 month ago	
usi	Verb	1 month ago	
usate	Verb	1 month ago	
ricordate	Verb	1 month ago	
ricorda	Verb	1 month ago	
passa	Verb	1 month ago	
chiedete	Verb	1 month ago	
chiedi	Verb	1 month ago	
offrii	Verb	1 month ago	
indicai	Verb	1 month ago	
avemmo	Verb	1 month ago	
offrì	Verb	1 month ago	
indicò	Verb	1 month ago	
scrissi	Verb	1 month ago	
ebbi	Verb	1 month ago	
fece	Verb	1 month ago	
giocarono	Verb	1 month ago	
giocammo	Verb	1 month ago	
decise	Verb	1 month ago	
parlò	Verb	1 month ago	
troppi	Determiner	1 month ago	
originali	Adjective	1 month ago	
responsabili	Adjective	1 month ago	
responsabile	Adjective	1 month ago	
originale	Adjective	1 month ago	
migliore	Adjective	1 month ago	
vicino	Adjective	1 month ago	
personali	Adjective	1 month ago	
locale	Adjective	1 month ago	
fresco	Adjective	1 month ago	
fresca	Adjective	1 month ago	
vicini	Adjective	1 month ago	
migliori	Adjective	1 month ago	
vicina	Adjective	1 month ago	
commerciali	Adjective	1 month ago	
divertente	Adjective	1 month ago	
ferroviaria	Adjective	1 month ago	
teatro	Noun	1 month ago	
teatri	Noun	1 month ago	
museo	Noun	1 month ago	
collina	Noun	1 month ago	
fattoria	Noun	1 month ago	
supermercato	Noun	1 month ago	
quartiere	Noun	1 month ago	
albergo	Noun	1 month ago	
campo	Noun	1 month ago	
topo	Noun	1 month ago	
orso	Noun	1 month ago	
tigre	Noun	1 month ago	
pinguino	Noun	1 month ago	
mosca	Noun	1 month ago	
anatra	Noun	1 month ago	
uccello	Noun	1 month ago	
bar	Noun	2 months ago	
ragazzi	Noun	2 months ago	
felicità	Noun	2 months ago	
niente	Pronoun	2 months ago	
tranquillo	Adjective	2 months ago	
speriamo	Verb	2 months ago	
aiuto	Noun	2 months ago	
paura	Noun	2 months ago	
emozione	Noun	2 months ago	
pazienza	Noun	2 months ago	
spero	Verb	2 months ago	
bugia	Noun	2 months ago	
bugie	Noun	2 months ago	
tranquilla	Adjective	2 months ago	
magari	Adverb	2 months ago	
facendo	Verb	2 months ago	
rimanesse	Verb	2 months ago	
stessi	Verb	2 months ago	
costruissero	Verb	2 months ago	
offrissi	Verb	2 months ago	
aspettassi	Verb	2 months ago	
cambiasse	Verb	2 months ago	
fosse	Verb	2 months ago	
diventassi	Verb	2 months ago	
entrare	Verb	2 months ago	
salve	Interjection	2 months ago	
opportunità	Noun	2 months ago	
prego	Verb	2 months ago	
preghiamo	Verb	2 months ago	
violenza	Noun	2 months ago	
frequenza	Noun	2 months ago	
buio	Noun	2 months ago	
sui	Preposition	2 months ago	
sofà	Noun	2 months ago	
telefono	Noun	2 months ago	
entrata	Noun	2 months ago	
mobile	Noun	2 months ago	
limpido	Adjective	2 months ago	
divani	Noun	2 months ago	
mobili	Noun	2 months ago	
asciugamani	Noun	2 months ago	
telefoni	Noun	2 months ago	
dentifricio	Noun	2 months ago	
divano	Noun	2 months ago	
limpida	Adjective	2 months ago	
cortile	Noun	2 months ago	
mia	Pronoun	2 months ago	
diversi	Determiner	2 months ago	
necessità	Noun	2 months ago	
responsabilità	Noun	2 months ago	
territorio	Noun	2 months ago	
giudizio	Noun	2 months ago	
presenza	Noun	2 months ago	
tipi	Noun	2 months ago	
tipo	Noun	2 months ago	
epoca	Noun	2 months ago	
giudizi	Noun	2 months ago	
azione	Noun	2 months ago	
tradizione	Noun	2 months ago	
settanta	Numeral	2 months ago	
ciotola	Noun	2 months ago	
quattordici	Numeral	2 months ago	
uno	Numeral	2 months ago	
settant'	Numeral	2 months ago	
venti	Numeral	2 months ago	
secondo	Adjective	2 months ago	
primo	Adjective	2 months ago	
primi	Adjective	2 months ago	
seconda	Adjective	2 months ago	
prima	Adjective	2 months ago	
mille	Numeral	2 months ago	
entrambe	Pronoun	2 months ago	
tesi	Noun	2 months ago	
compiti	Noun	2 months ago	
parola	Noun	2 months ago	
principiante	Noun	2 months ago	
dipartimenti	Noun	2 months ago	
parole	Noun	2 months ago	
descrizione	Noun	2 months ago	
insegnanti	Noun	2 months ago	
insegnante	Noun	2 months ago	
storie	Noun	2 months ago	
dipartimento	Noun	2 months ago	
storia	Noun	2 months ago	
spiegazione	Noun	2 months ago	
manzo	Noun	2 months ago	
li	Pronoun	2 months ago	
vi	Pronoun	2 months ago	
trent'	Numeral	2 months ago	
leone	Noun	2 months ago	
interessante	Adjective	2 months ago	
certe	Adjective	2 months ago	
difficili	Adjective	2 months ago	
forti	Adjective	2 months ago	
forte	Adjective	2 months ago	
facile	Adjective	2 months ago	
stranieri	Adjective	2 months ago	
certi	Adjective	2 months ago	
aperta	Adjective	2 months ago	
straniera	Adjective	2 months ago	
utili	Adjective	2 months ago	
interessanti	Adjective	2 months ago	
chiara	Adjective	2 months ago	
attività	Noun	2 months ago	
tuttavia	Adverb	2 months ago	
correre	Verb	2 months ago	
grandiosi	Adjective	2 months ago	
soffici	Adjective	2 months ago	
silenziosa	Adjective	2 months ago	
abituale	Adjective	2 months ago	
silenzioso	Adjective	2 months ago	
scure	Adjective	2 months ago	
soffice	Adjective	2 months ago	
potenziali	Adjective	2 months ago	
abituali	Adjective	2 months ago	
grandiosa	Adjective	2 months ago	
emozionante	Adjective	2 months ago	
bionde	Adjective	2 months ago	
costosi	Adjective	2 months ago	
scuri	Adjective	2 months ago	
costose	Adjective	2 months ago	
costoso	Adjective	2 months ago	
grandioso	Adjective	2 months ago	
ora	Noun	2 months ago	
mezzanotte	Noun	2 months ago	
ore	Noun	2 months ago	
luglio	Noun	2 months ago	
inverno	Noun	2 months ago	
pomeriggio	Noun	2 months ago	
settembre	Noun	2 months ago	
domenica	Noun	2 months ago	
quasi	Adverb	2 months ago	
fino	Preposition	2 months ago	
spostano	Verb	2 months ago	
pescano	Verb	2 months ago	
baciano	Verb	2 months ago	
piangi	Verb	2 months ago	
ringrazia	Verb	2 months ago	
ringrazio	Verb	2 months ago	
spostiamo	Verb	2 months ago	
ripara	Verb	2 months ago	
fuma	Verb	2 months ago	
ripariamo	Verb	2 months ago	
sposta	Verb	2 months ago	
allena	Verb	2 months ago	
riparano	Verb	2 months ago	
riparo	Verb	2 months ago	
giudica	Verb	2 months ago	
pesca	Verb	2 months ago	
giudichiamo	Verb	2 months ago	
bacia	Verb	2 months ago	
dalla	Preposition	2 months ago	
segretario	Noun	2 months ago	
dottori	Noun	2 months ago	
poliziotta	Noun	2 months ago	
avvocato	Noun	2 months ago	
pescatore	Noun	2 months ago	
contadino	Noun	2 months ago	
capitano	Noun	2 months ago	
contadini	Noun	2 months ago	
poliziotti	Noun	2 months ago	
ingegnere	Noun	2 months ago	
pescatrice	Noun	2 months ago	
avvocati	Noun	2 months ago	
ingegneri	Noun	2 months ago	
meccanici	Noun	2 months ago	
poliziotto	Noun	2 months ago	
meccanico	Noun	2 months ago	
dottoressa	Noun	2 months ago	
dottore	Noun	2 months ago	
terreno	Noun	2 months ago	
fiori	Noun	2 months ago	
terreni	Noun	2 months ago	
fiumi	Noun	2 months ago	
fiore	Noun	2 months ago	
rocce	Noun	2 months ago	
caldo	Noun	2 months ago	
nebbia	Noun	2 months ago	
fiume	Noun	2 months ago	
uccelli	Noun	2 months ago	
sapevo	Verb	2 months ago	
venivano	Verb	2 months ago	
stava	Verb	2 months ago	
vedeva	Verb	2 months ago	
sapeva	Verb	2 months ago	
stavo	Verb	2 months ago	
rimaneva	Verb	2 months ago	
davamo	Verb	2 months ago	
ricordava	Verb	2 months ago	
stavi	Verb	2 months ago	
cambiava	Verb	2 months ago	
veniva	Verb	2 months ago	
venivi	Verb	2 months ago	
ricordavo	Verb	2 months ago	
vedevo	Verb	2 months ago	
rimanevano	Verb	2 months ago	
dava	Verb	2 months ago	
scriveva	Verb	2 months ago	
altra	Pronoun	2 months ago	
note	Noun	2 months ago	
soggetto	Noun	2 months ago	
discorso	Noun	2 months ago	
nota	Noun	2 months ago	
lettere	Noun	2 months ago	
discorsi	Noun	2 months ago	
discussione	Noun	2 months ago	
commenti	Noun	2 months ago	
lettera	Noun	2 months ago	
articoli	Noun	2 months ago	
notizia	Noun	2 months ago	
articolo	Noun	2 months ago	
notizie	Noun	2 months ago	
vacanza	Noun	2 months ago	
aeroporto	Noun	2 months ago	
conto	Noun	2 months ago	
portoghesi	Adjective	2 months ago	
treno	Noun	2 months ago	
tedeschi	Noun	2 months ago	
spagnolo	Adjective	2 months ago	
spagnoli	Adjective	2 months ago	
italiano	Adjective	2 months ago	
tedesco	Noun	2 months ago	
estero	Noun	2 months ago	
treni	Noun	2 months ago	
vacanze	Noun	2 months ago	
facilmente	Adverb	2 months ago	
riposare	Verb	2 months ago	
bicchiere	Noun	2 months ago	
bruciare	Verb	2 months ago	
invitare	Verb	2 months ago	
spesso	Adverb	2 months ago	
fallire	Verb	2 months ago	
concordare	Verb	2 months ago	
migliorare	Verb	2 months ago	
riempire	Verb	2 months ago	
viaggiare	Verb	2 months ago	
immaginare	Verb	2 months ago	
ricetta	Noun	2 months ago	
ferma	Verb	2 months ago	
ascolta	Verb	2 months ago	
incontri	Verb	2 months ago	
invitiamo	Verb	2 months ago	
inviti	Verb	2 months ago	
invita	Verb	2 months ago	
impari	Verb	2 months ago	
impariamo	Verb	2 months ago	
ascoltano	Verb	2 months ago	
aiuta	Verb	2 months ago	
descrivi	Verb	2 months ago	
dimostra	Verb	2 months ago	
tira	Verb	2 months ago	
incontriamo	Verb	2 months ago	
nostre	Determiner	2 months ago	
lavorare	Verb	2 months ago	
soldi	Noun	2 months ago	
assicurazione	Noun	2 months ago	
fabbriche	Noun	2 months ago	
riunioni	Noun	2 months ago	
fabbrica	Noun	2 months ago	
appuntamento	Noun	2 months ago	
compagnia	Noun	2 months ago	
contanti	Noun	2 months ago	
appuntamenti	Noun	2 months ago	
riunione	Noun	2 months ago	
prodotti	Noun	2 months ago	
parlando	Verb	2 months ago	
bevendo	Verb	2 months ago	
mettendo	Verb	2 months ago	
scrivendo	Verb	2 months ago	
aprendo	Verb	2 months ago	
unendo	Verb	2 months ago	
dicendo	Verb	2 months ago	
arrivando	Verb	2 months ago	
dormendo	Verb	2 months ago	
polizia	Noun	2 months ago	
attacchi	Noun	2 months ago	
sindacato	Noun	2 months ago	
candidati	Noun	2 months ago	
congresso	Noun	2 months ago	
libertà	Noun	2 months ago	
sindacati	Noun	2 months ago	
candidato	Noun	2 months ago	
candidata	Noun	2 months ago	
diritto	Noun	2 months ago	
congressi	Noun	2 months ago	
diritti	Noun	2 months ago	
gol	Noun	2 months ago	
tennis	Noun	2 months ago	
nostra	Determiner	2 months ago	
pallacanestro	Noun	2 months ago	
mondiale	Adjective	2 months ago	
squadra	Noun	2 months ago	
spettatore	Noun	2 months ago	
piscina	Noun	2 months ago	
campionato	Noun	2 months ago	
spettatori	Noun	2 months ago	
partita	Noun	2 months ago	
dimostrare	Verb	2 months ago	
tenere	Verb	2 months ago	
suonare	Verb	2 months ago	
ripetere	Verb	2 months ago	
scegliere	Verb	2 months ago	
senz'	Preposition	2 months ago	
amare	Verb	2 months ago	
mancare	Verb	2 months ago	
rispondere	Verb	2 months ago	
patria	Noun	2 months ago	
sindaco	Noun	2 months ago	
pace	Noun	2 months ago	
sciopero	Noun	2 months ago	
repubblica	Noun	2 months ago	
democrazia	Noun	2 months ago	
dittatura	Noun	2 months ago	
personalità	Noun	2 months ago	
carattere	Noun	2 months ago	
compagno	Noun	2 months ago	
individuo	Noun	2 months ago	
gruppo	Noun	2 months ago	
giovane	Noun	2 months ago	
adolescenti	Noun	2 months ago	
adolescente	Noun	2 months ago	
individui	Noun	2 months ago	
vicina	Noun	2 months ago	
vicini	Noun	2 months ago	
signora	Noun	2 months ago	
su	Preposition	2 months ago	
nave	Noun	2 months ago	
ruota	Noun	2 months ago	
navi	Noun	2 months ago	
fogli	Noun	2 months ago	
scatole	Noun	2 months ago	
benzina	Noun	2 months ago	
pettine	Noun	2 months ago	
strumento	Noun	2 months ago	
strumenti	Noun	2 months ago	
tastiera	Noun	2 months ago	
foglio	Noun	2 months ago	
ruote	Noun	2 months ago	
motore	Noun	2 months ago	
scatola	Noun	2 months ago	
pescare	Verb	2 months ago	
lentamente	Adverb	2 months ago	
rimase	Verb	2 months ago	
morirono	Verb	2 months ago	
unì	Verb	2 months ago	
aprii	Verb	2 months ago	
arrivò	Verb	2 months ago	
morì	Verb	2 months ago	
unirono	Verb	2 months ago	
andammo	Verb	2 months ago	
andarono	Verb	2 months ago	
aspettai	Verb	2 months ago	
unisti	Verb	2 months ago	
arrivarono	Verb	2 months ago	
usò	Verb	2 months ago	
aprirono	Verb	2 months ago	
aprì	Verb	2 months ago	
aprisse	Verb	2 months ago	
entrassero	Verb	2 months ago	
venisse	Verb	2 months ago	
entrasse	Verb	2 months ago	
perdessero	Verb	2 months ago	
andassi	Verb	2 months ago	
pensassi	Verb	2 months ago	
perdessi	Verb	2 months ago	
venissi	Verb	2 months ago	
andasse	Verb	2 months ago	
scrivesse	Verb	2 months ago	
conoscesse	Verb	2 months ago	
carriera	Noun	2 months ago	
allora	Adverb	2 months ago	
nessuno	Pronoun	2 months ago	
internet	Noun	2 months ago	
mercati	Noun	2 months ago	
imprenditore	Noun	2 months ago	
mercato	Noun	2 months ago	
sconto	Noun	2 months ago	
tassa	Noun	2 months ago	
personale	Noun	2 months ago	
tasse	Noun	2 months ago	
sconti	Noun	2 months ago	
impresa	Noun	2 months ago	
durante	Preposition	2 months ago	
stampare	Verb	2 months ago	
intervista	Noun	2 months ago	
messaggio	Noun	2 months ago	
messaggi	Noun	2 months ago	
indirizzo	Noun	2 months ago	
televisore	Noun	2 months ago	
codice	Noun	2 months ago	
posta	Noun	2 months ago	
televisori	Noun	2 months ago	
indirizzi	Noun	2 months ago	
codici	Noun	2 months ago	
morire	Verb	2 months ago	
velocemente	Adverb	2 months ago	
giornali	Noun	2 months ago	
venni	Verb	2 months ago	
costruì	Verb	2 months ago	
lessi	Verb	2 months ago	
venne	Verb	2 months ago	
guardai	Verb	2 months ago	
tenne	Verb	2 months ago	
passarono	Verb	2 months ago	
stette	Verb	2 months ago	
guardarono	Verb	2 months ago	
rispose	Verb	2 months ago	
leggesti	Verb	2 months ago	
però	Adverb	2 months ago	
direbbero	Verb	2 months ago	
mangeresti	Verb	2 months ago	
deciderebbe	Verb	2 months ago	
deciderei	Verb	2 months ago	
darebbe	Verb	2 months ago	
suoneresti	Verb	2 months ago	
direi	Verb	2 months ago	
mangerebbe	Verb	2 months ago	
chiederei	Verb	2 months ago	
aprirebbe	Verb	2 months ago	
rimarrebbe	Verb	2 months ago	
penserei	Verb	2 months ago	
suonerei	Verb	2 months ago	
mangerebbero	Verb	2 months ago	
daresti	Verb	2 months ago	
direbbe	Verb	2 months ago	
gas	Noun	2 months ago	
collegamento	Noun	2 months ago	
collegamenti	Noun	2 months ago	
ricerca	Noun	2 months ago	
scienza	Noun	2 months ago	
biologia	Noun	2 months ago	
fisica	Noun	2 months ago	
scienze	Noun	2 months ago	
tecnologia	Noun	2 months ago	
idea	Noun	2 months ago	
sicuramente	Adverb	2 months ago	
filmare	Verb	2 months ago	
dipingere	Verb	2 months ago	
video	Noun	2 months ago	
immagini	Noun	2 months ago	
arte	Noun	2 months ago	
esibizione	Noun	2 months ago	
immagine	Noun	2 months ago	
letteratura	Noun	2 months ago	
canzone	Noun	2 months ago	
canzoni	Noun	2 months ago	
desse	Verb	2 months ago	
lasciasse	Verb	2 months ago	
vedesse	Verb	2 months ago	
finisse	Verb	2 months ago	
indicasse	Verb	2 months ago	
cambierà	Verb	2 months ago	
diventerai	Verb	2 months ago	
verrò	Verb	2 months ago	
avrai	Verb	2 months ago	
diventeremo	Verb	2 months ago	
lascerai	Verb	2 months ago	
terrai	Verb	2 months ago	
cambierò	Verb	2 months ago	
verrai	Verb	2 months ago	
starai	Verb	2 months ago	
avrà	Verb	2 months ago	
avremo	Verb	2 months ago	
lascerò	Verb	2 months ago	
porterò	Verb	2 months ago	
verranno	Verb	2 months ago	
staremo	Verb	2 months ago	
avrò	Verb	2 months ago	
ovest	Noun	2 months ago	
davanti	Preposition	2 months ago	
interiori	Noun	2 months ago	
direzione	Noun	2 months ago	
lontano	Adjective	2 months ago	
distanza	Noun	2 months ago	
lontana	Adjective	2 months ago	
posizione	Noun	2 months ago	
fronte	Noun	2 months ago	
uscita	Noun	2 months ago	
interiore	Noun	2 months ago	
distanze	Noun	2 months ago	
male	Adverb	2 months ago	
farfalle	Noun	2 months ago	
braccio	Noun	2 months ago	
sana	Adjective	2 months ago	
sano	Adjective	2 months ago	
dentista	Noun	2 months ago	
unghie	Noun	2 months ago	
stomaco	Noun	2 months ago	
cervello	Noun	2 months ago	
naso	Noun	2 months ago	
dallo	Preposition	3 months ago	
simili	Adjective	3 months ago	
scorso	Adjective	3 months ago	
regionale	Adjective	3 months ago	
positivo	Adjective	3 months ago	
culturali	Adjective	3 months ago	
naturali	Adjective	3 months ago	
legale	Adjective	3 months ago	
scorsa	Adjective	3 months ago	
simile	Adjective	3 months ago	
legali	Adjective	3 months ago	
seguenti	Adjective	3 months ago	
positiva	Adjective	3 months ago	
positive	Adjective	3 months ago	
regionali	Adjective	3 months ago	
seguente	Adjective	3 months ago	
culturale	Adjective	3 months ago	
naturale	Adjective	3 months ago	
quantità	Noun	3 months ago	
opzione	Noun	3 months ago	
significato	Noun	3 months ago	
nemici	Noun	3 months ago	
nemica	Noun	3 months ago	
nazioni	Noun	3 months ago	
nazione	Noun	3 months ago	
passione	Noun	3 months ago	
opzioni	Noun	3 months ago	
nemico	Noun	3 months ago	
influenza	Noun	3 months ago	
ieri	Adverb	3 months ago	
tazza	Noun	3 months ago	
rumorose	Adjective	3 months ago	
rumorosi	Adjective	3 months ago	
tonda	Adjective	3 months ago	
sbagliato	Adjective	3 months ago	
secca	Adjective	3 months ago	
vuoto	Adjective	3 months ago	
meraviglioso	Adjective	3 months ago	
rumorosa	Adjective	3 months ago	
vuota	Adjective	3 months ago	
secchi	Adjective	3 months ago	
sottile	Adjective	3 months ago	
sbagliata	Adjective	3 months ago	
consapevole	Adjective	3 months ago	
miglio	Noun	3 months ago	
lungo	Preposition	3 months ago	
pochino	Noun	3 months ago	
quarto	Noun	3 months ago	
centimetri	Noun	3 months ago	
misure	Noun	3 months ago	
misura	Noun	3 months ago	
metro	Noun	3 months ago	
metri	Noun	3 months ago	
totale	Noun	3 months ago	
centimetro	Noun	3 months ago	
dimenticare	Verb	3 months ago	
spingere	Verb	3 months ago	
supporre	Verb	3 months ago	
prestare	Verb	3 months ago	
descrivere	Verb	3 months ago	
guadagnare	Verb	3 months ago	
giochi	Verb	3 months ago	
stia	Verb	3 months ago	
provi	Verb	3 months ago	
giochiate	Verb	3 months ago	
diventi	Verb	3 months ago	
mettano	Verb	3 months ago	
muoia	Verb	3 months ago	
diventino	Verb	3 months ago	
veda	Verb	3 months ago	
chissà	Adverb	3 months ago	
chi		3 months ago	
pomodoro	Noun	3 months ago	
pesci	Noun	3 months ago	
banana	Noun	3 months ago	
mele	Noun	3 months ago	
rossi	Adjective	3 months ago	
neri	Adjective	3 months ago	
colore	Noun	3 months ago	
arancioni	Adjective	3 months ago	
azzurre	Adjective	3 months ago	
rosso	Adjective	3 months ago	
verde	Adjective	3 months ago	
nera	Adjective	3 months ago	
bianca	Adjective	3 months ago	
bianche	Adjective	3 months ago	
gialli	Adjective	3 months ago	
colori	Noun	3 months ago	
rossa	Adjective	3 months ago	
gialla	Adjective	3 months ago	
arancione	Adjective	3 months ago	
gialle	Adjective	3 months ago	
rosse	Adjective	3 months ago	
azzurra	Adjective	3 months ago	
nero	Adjective	3 months ago	
difficoltà	Noun	3 months ago	
preoccupare	Verb	3 months ago	
sognare	Verb	3 months ago	
confondere	Verb	3 months ago	
portavano	Verb	3 months ago	
facevi	Verb	3 months ago	
vivevamo	Verb	3 months ago	
conosceva	Verb	3 months ago	
mettevo	Verb	3 months ago	
viveva	Verb	3 months ago	
teneva	Verb	3 months ago	
arrivava	Verb	3 months ago	
diventava	Verb	3 months ago	
piaceva	Verb	3 months ago	
perdevano	Verb	3 months ago	
col	Preposition	3 months ago	
luogo	Noun	3 months ago	
cinesi	Adjective	3 months ago	
prenotazione	Noun	3 months ago	
luoghi	Noun	3 months ago	
vista	Noun	3 months ago	
continente	Noun	3 months ago	
campeggio	Noun	3 months ago	
aeroplano	Noun	3 months ago	
aeroplani	Noun	3 months ago	
brasiliano	Adjective	3 months ago	
cinese	Adjective	3 months ago	
brasiliani	Adjective	3 months ago	
fra	Preposition	3 months ago	
entrate	Verb	3 months ago	
lavorate	Verb	3 months ago	
tieni	Verb	3 months ago	
teniamo	Verb	3 months ago	
lavora	Verb	3 months ago	
seguite	Verb	3 months ago	
trova	Verb	3 months ago	
vai	Verb	3 months ago	
andiamo	Verb	3 months ago	
dite	Verb	3 months ago	
diciamo	Verb	3 months ago	
andate	Verb	3 months ago	
segui	Verb	3 months ago	
sale	Noun	3 months ago	
vegetariano	Noun	3 months ago	
cipolla	Noun	3 months ago	
cucina	Noun	3 months ago	
dolce	Adjective	3 months ago	
salsiccia	Noun	3 months ago	
ingrediente	Noun	3 months ago	
speranza	Noun	3 months ago	
cuochi	Noun	3 months ago	
trovando	Verb	3 months ago	
usando	Verb	3 months ago	
rimanendo	Verb	3 months ago	
cercando	Verb	3 months ago	
decidendo	Verb	3 months ago	
includendo	Verb	3 months ago	
suonando	Verb	3 months ago	
praticamente	Adverb	3 months ago	
normalmente	Adverb	3 months ago	
infatti	Adverb	3 months ago	
necessariamente	Adverb	3 months ago	
esattamente	Adverb	3 months ago	
sinceramente	Adverb	3 months ago	
conferenza	Noun	3 months ago	
capi	Noun	3 months ago	
clienti	Noun	3 months ago	
vendite	Noun	3 months ago	
dover	Verb	3 months ago	
diciassette	Numeral	3 months ago	
ottanta	Numeral	3 months ago	
trenta	Numeral	3 months ago	
svegliare	Verb	3 months ago	
cambiare	Verb	3 months ago	
nostri	Pronoun	3 months ago	
costume	Noun	3 months ago	
sandali	Noun	3 months ago	
divisa	Noun	3 months ago	
gonna	Noun	3 months ago	
portafogli	Noun	3 months ago	
sandalo	Noun	3 months ago	
portafoglio	Noun	3 months ago	
cuoio	Noun	3 months ago	
scarpe	Noun	3 months ago	
scarpa	Noun	3 months ago	
cappotto	Noun	3 months ago	
visitare	Verb	3 months ago	
colpire	Verb	3 months ago	
cadere	Verb	3 months ago	
girare	Verb	3 months ago	
indossare	Verb	3 months ago	
ascoltare	Verb	3 months ago	
parecchio	Determiner	3 months ago	
parecchia	Determiner	3 months ago	
quei	Determiner	3 months ago	
parecchie	Determiner	3 months ago	
succo	Noun	3 months ago	
parecchi	Determiner	3 months ago	
dalle	Preposition	3 months ago	
quest'	Determiner	3 months ago	
biscotto	Noun	3 months ago	
qualità	Noun	3 months ago	
sport	Noun	3 months ago	
pubblico	Noun	3 months ago	
numerosa	Adjective	3 months ago	
carina	Adjective	3 months ago	
noioso	Adjective	3 months ago	
entrambi	Pronoun	3 months ago	
alcuna	Pronoun	3 months ago	
tutta	Pronoun	3 months ago	
questi	Pronoun	3 months ago	
ciò	Pronoun	3 months ago	
quelli	Pronoun	3 months ago	
qualsiasi	Pronoun	3 months ago	
pullman	Noun	4 months ago	
angeli	Noun	4 months ago	
tartaruga	Noun	4 months ago	
piovere	Verb	4 months ago	
sabbia	Noun	4 months ago	
vulcano	Noun	4 months ago	
fumo	Noun	4 months ago	
clima	Noun	4 months ago	
atmosfera	Noun	4 months ago	
credere	Verb	4 months ago	
passare	Verb	4 months ago	
portare	Verb	4 months ago	
bere	Verb	4 months ago	
palazzo	Noun	4 months ago	
negozio	Noun	4 months ago	
porto	Noun	4 months ago	
città	Noun	4 months ago	
piazza	Noun	4 months ago	
sulle	Preposition	4 months ago	
ricercare	Verb	4 months ago	
plastica	Noun	4 months ago	
teorie	Noun	4 months ago	
universo	Noun	4 months ago	
scienziate	Noun	4 months ago	
scienziato	Noun	4 months ago	
scienziati	Noun	4 months ago	
scienziata	Noun	4 months ago	
teoria	Noun	4 months ago	
psicologia	Noun	4 months ago	
pagamento	Noun	4 months ago	
bolletta	Noun	4 months ago	
cascata	Noun	4 months ago	
fuoco	Noun	4 months ago	
romanzo	Noun	4 months ago	
fotografica	Adjective	4 months ago	
classico	Adjective	4 months ago	
piacendo	Verb	4 months ago	
succedendo	Verb	4 months ago	
passando	Verb	4 months ago	
chiamando	Verb	4 months ago	
lasciando	Verb	4 months ago	
credendo	Verb	4 months ago	
costruendo	Verb	4 months ago	
tentando	Verb	4 months ago	
malati	Adjective	4 months ago	
denti	Noun	4 months ago	
interventi	Noun	4 months ago	
intervento	Noun	4 months ago	
testa	Noun	4 months ago	
malato	Adjective	4 months ago	
organi	Noun	4 months ago	
malata	Adjective	4 months ago	
organo	Noun	4 months ago	
lacrime	Noun	4 months ago	
ognuno	Pronoun	4 months ago	
leggendo	Verb	4 months ago	
argomento	Noun	4 months ago	
argomenti	Noun	4 months ago	
affare	Noun	4 months ago	
affari	Noun	4 months ago	
uguale	Adverb	4 months ago	
solamente	Adverb	4 months ago	
dappertutto	Adverb	4 months ago	
estremamente	Adverb	4 months ago	
nemmeno	Adverb	4 months ago	
naturalmente	Adverb	4 months ago	
ecco	Adverb	4 months ago	
chiaramente	Adverb	4 months ago	
finalmente	Adverb	4 months ago	
quello	Determiner	4 months ago	
pensarci	Pronoun	4 months ago	
incontrare	Verb	4 months ago	
ritornare	Verb	4 months ago	
mandare	Verb	4 months ago	
pensiamoci	Pronoun	4 months ago	
chiamiamoci	Pronoun	4 months ago	
sessant'	Numeral	4 months ago	
avendo	Verb	4 months ago	
sentendo	Verb	4 months ago	
piovendo	Verb	4 months ago	
preparando	Verb	4 months ago	
essendo	Verb	4 months ago	
brutta	Adjective	4 months ago	
brutte	Adjective	4 months ago	
brutto	Adjective	4 months ago	
uguali	Adjective	4 months ago	
italiana	Adjective	4 months ago	
inglese	Noun	4 months ago	
isola	Noun	4 months ago	
isole	Noun	4 months ago	
dietro	Adverb	4 months ago	
sud	Noun	4 months ago	
est	Noun	4 months ago	
nord	Noun	4 months ago	
mezzi	Noun	4 months ago	
ottobre	Noun	4 months ago	
cosa	Noun	4 months ago	
cose	Noun	4 months ago	
seguì	Verb	4 months ago	
guadagna	Verb	4 months ago	
ride	Verb	4 months ago	
accettano	Verb	4 months ago	
accetti	Verb	4 months ago	
abbassano	Verb	4 months ago	
accettate	Verb	4 months ago	
pulisci	Verb	4 months ago	
spinge	Verb	4 months ago	
spingiamo	Verb	4 months ago	
pulisco	Verb	4 months ago	
asciuga	Verb	4 months ago	
pulite	Verb	4 months ago	
ridono	Verb	4 months ago	
grida	Verb	4 months ago	
puliamo	Verb	4 months ago	
gridano	Verb	4 months ago	
ridete	Verb	4 months ago	
abbassiamo	Verb	4 months ago	
prenota	Verb	4 months ago	
soprattutto	Adverb	4 months ago	
pezzo	Noun	4 months ago	
pezzi	Noun	4 months ago	
ovviamente	Adverb	4 months ago	
francia	Proper noun	4 months ago	
grosso	Adjective	4 months ago	
famoso	Adjective	4 months ago	
foto	Noun	4 months ago	
musicista	Noun	4 months ago	
musicisti	Noun	4 months ago	
pianoforte	Noun	4 months ago	
specialità	Noun	4 months ago	
papà	Noun	4 months ago	
mamma	Noun	4 months ago	
grammi	Noun	4 months ago	
grammo	Noun	4 months ago	
cina	Proper noun	4 months ago	
bambino	Noun	4 months ago	
cittadini	Noun	4 months ago	
bambini	Noun	4 months ago	
umano	Adjective	4 months ago	
ospiti	Noun	4 months ago	
bevono	Verb	4 months ago	
legge	Verb	4 months ago	
scrivo	Verb	4 months ago	
scrivono	Verb	4 months ago	
leggete	Verb	4 months ago	
ha	Verb	4 months ago	
leggiamo	Verb	4 months ago	
agli	Preposition	4 months ago	
dagli	Preposition	4 months ago	
nonostante	Preposition	4 months ago	
duro	Adjective	4 months ago	
dura	Adjective	4 months ago	
capisse	Verb	4 months ago	
succedesse	Verb	4 months ago	
leggessero	Verb	4 months ago	
sono	Verb	4 months ago	
mangio	Verb	4 months ago	
bevo	Verb	4 months ago	
bevi	Verb	4 months ago	
sei	Verb	4 months ago	
mangia	Verb	4 months ago	
mangi	Verb	4 months ago	
beve	Verb	4 months ago	
è	Verb	4 months ago	
direttamente	Adverb	5 months ago	
fortemente	Adverb	5 months ago	
totalmente	Adverb	5 months ago	
effettivamente	Adverb	5 months ago	
possibilmente	Adverb	5 months ago	
fortunatamente	Adverb	5 months ago	
arrabbiato	Adjective	5 months ago	
felice	Adjective	5 months ago	
risata	Noun	5 months ago	
allegria	Noun	5 months ago	
giocavamo	Verb	5 months ago	
offrire	Verb	5 months ago	
chiudere	Verb	5 months ago	
leggere	Verb	5 months ago	
trovare	Verb	5 months ago	
parlare	Verb	5 months ago	
conoscere	Verb	5 months ago	
amministrazione	Noun	5 months ago	
quali		5 months ago	
queste	Pronoun	5 months ago	
nessuna	Pronoun	5 months ago	
quale		5 months ago	
euro	Noun	5 months ago	
lavare	Verb	5 months ago	
ferire	Verb	5 months ago	
rompere	Verb	5 months ago	
prenotare	Verb	5 months ago	
appartenere	Verb	5 months ago	
proprietà	Noun	5 months ago	
parete	Noun	5 months ago	
linguaggio	Noun	5 months ago	
riflessione	Noun	5 months ago	
nevicare	Verb	5 months ago	
boschi	Noun	5 months ago	
quegli	Determiner	5 months ago	
nessun	Determiner	5 months ago	
certe	Determiner	5 months ago	
certa	Determiner	5 months ago	
origine	Noun	5 months ago	
dito	Noun	5 months ago	
caviglia	Noun	5 months ago	
mal	Noun	5 months ago	
osso	Noun	5 months ago	
ginocchio	Noun	5 months ago	
rete	Noun	5 months ago	
comunque	Adverb	5 months ago	
veramente	Adverb	5 months ago	
pure	Adverb	5 months ago	
prima	Adverb	5 months ago	
piena	Adjective	5 months ago	
pieno	Adjective	5 months ago	
moderna	Adjective	5 months ago	
stesso	Adjective	5 months ago	
luce	Noun	5 months ago	
luci	Noun	5 months ago	
mezzogiorno	Noun	5 months ago	
perdo	Verb	5 months ago	
italia	Proper noun	5 months ago	
germania	Proper noun	5 months ago	
chilometri	Noun	5 months ago	
festa	Noun	5 months ago	
casa	Noun	5 months ago	
case	Noun	5 months ago	
nazionali	Adjective	5 months ago	
perfetto	Adjective	5 months ago	
anno	Noun	5 months ago	
sentiamo	Verb	5 months ago	
anni	Noun	5 months ago	
simbolo	Noun	5 months ago	
fede	Noun	5 months ago	
meditazione	Noun	5 months ago	
testo	Noun	5 months ago	
ricercatore	Noun	5 months ago	
vedessi	Verb	5 months ago	
trovassimo	Verb	5 months ago	
associazione	Noun	5 months ago	
moneta	Noun	5 months ago	
contratti	Noun	5 months ago	
esperta	Noun	5 months ago	
metodo	Noun	5 months ago	
vivrà	Verb	5 months ago	
verremo	Verb	5 months ago	
vivrò	Verb	5 months ago	
europa	Proper noun	5 months ago	
africa	Proper noun	5 months ago	
brasile	Proper noun	5 months ago	
stranieri	Noun	5 months ago	
straniera	Noun	5 months ago	
avventura	Noun	5 months ago	
mappa	Noun	5 months ago	
straniero	Noun	5 months ago	
potendo	Verb	5 months ago	
cucinando	Verb	5 months ago	
studiando	Verb	5 months ago	
nuotando	Verb	5 months ago	
preferire	Verb	5 months ago	
ricevere	Verb	5 months ago	
tirare	Verb	5 months ago	
seguire	Verb	5 months ago	
unire	Verb	5 months ago	
vivete	Verb	5 months ago	
negli	Preposition	5 months ago	
pubblicità	Noun	5 months ago	
siete	Verb	5 months ago	
scrivi	Verb	5 months ago	
leggono	Verb	5 months ago	
libro	Noun	5 months ago	
addirittura	Adverb	5 months ago	
immediatamente	Adverb	5 months ago	
bandiera	Noun	6 months ago	
giustizia	Noun	6 months ago	
democratici	Adjective	6 months ago	
conoscendo	Verb	6 months ago	
rispondendo	Verb	6 months ago	
pagando	Verb	6 months ago	
indicando	Verb	6 months ago	
seguendo	Verb	6 months ago	
pulire	Verb	6 months ago	
lasciarvi	Pronoun	6 months ago	
tranne	Preposition	6 months ago	
attraverso	Adverb	6 months ago	
dentro	Preposition	6 months ago	
cui		6 months ago	
molti	Pronoun	6 months ago	
studiare	Verb	6 months ago	
lezione	Noun	6 months ago	
rimarrai	Verb	6 months ago	
rimasero	Verb	6 months ago	
piacque	Verb	6 months ago	
piacquero	Verb	6 months ago	
formula	Noun	6 months ago	
risponde	Verb	6 months ago	
sangue	Noun	6 months ago	
tengano	Verb	6 months ago	
conosca	Verb	6 months ago	
dia	Verb	6 months ago	
faccia	Verb	6 months ago	
sei	Numeral	6 months ago	
sedici	Numeral	6 months ago	
novanta	Numeral	6 months ago	
violini	Noun	6 months ago	
benissimo	Adverb	6 months ago	
giovedì	Noun	6 months ago	
sapesse	Verb	6 months ago	
giocassero	Verb	6 months ago	
arrivasse	Verb	6 months ago	
conduttore	Noun	6 months ago	
primavera	Noun	6 months ago	
giusto	Adjective	6 months ago	
giusta	Adjective	6 months ago	
seria	Adjective	6 months ago	
senso	Noun	6 months ago	
imbarazzata	Adjective	6 months ago	
piaccia	Verb	6 months ago	
chiamino	Verb	6 months ago	
cambino	Verb	6 months ago	
credano	Verb	6 months ago	
creda	Verb	6 months ago	
vogliono	Verb	6 months ago	
volete	Verb	6 months ago	
vuole	Verb	6 months ago	
possono	Verb	6 months ago	
martedì	Noun	6 months ago	
nelle	Preposition	6 months ago	
montagna	Noun	6 months ago	
ambiente	Noun	6 months ago	
chiesa	Noun	6 months ago	
preghiera	Noun	6 months ago	
salute	Noun	6 months ago	
faccia	Noun	6 months ago	
preferito	Adjective	6 months ago	
altrimenti	Adverb	6 months ago	
oltretutto	Adverb	6 months ago	
colpa	Noun	6 months ago	
stanotte	Adverb	6 months ago	
almeno	Adverb	6 months ago	
prova	Verb	6 months ago	
chilogrammo	Noun	6 months ago	
litro	Noun	6 months ago	
proviamo	Verb	6 months ago	
provano	Verb	6 months ago	
chilogrammi	Noun	6 months ago	
litri	Noun	6 months ago	
dimostrazione	Noun	6 months ago	
verrebbe	Verb	6 months ago	
elettrici	Adjective	6 months ago	
aprire	Verb	6 months ago	
paese	Noun	7 months ago	
contro	Preposition	7 months ago	
enorme	Adjective	7 months ago	
guardare	Verb	7 months ago	
decidere	Verb	7 months ago	
indicare	Verb	7 months ago	
sentire	Verb	7 months ago	
sessanta	Numeral	7 months ago	
pensare	Verb	7 months ago	
cammini	Verb	7 months ago	
certi	Determiner	7 months ago	
zero	Numeral	7 months ago	
angoli	Noun	7 months ago	
angolo	Noun	7 months ago	
pericoloso	Adjective	7 months ago	
bella	Adjective	7 months ago	
bello	Adjective	7 months ago	
quarto	Adjective	7 months ago	
trovasse	Verb	7 months ago	
cambiassero	Verb	7 months ago	
assolutamente	Adverb	7 months ago	
decenni	Noun	7 months ago	
capo	Noun	7 months ago	
autunno	Noun	7 months ago	
stivali	Noun	7 months ago	
entrarono	Verb	7 months ago	
provò	Verb	7 months ago	
scrisse	Verb	7 months ago	
perdere	Verb	7 months ago	
aiutare	Verb	7 months ago	
signore	Noun	7 months ago	
dicembre	Noun	7 months ago	
settimanalmente	Adverb	7 months ago	
ombrello	Noun	7 months ago	
ombrelli	Noun	7 months ago	
troppe	Determiner	7 months ago	
quelli	Determiner	7 months ago	
qualunque	Determiner	7 months ago	
tredici	Numeral	7 months ago	
undici	Numeral	7 months ago	
entro	Preposition	7 months ago	
pagare	Verb	7 months ago	
valore	Noun	7 months ago	
cliente	Noun	7 months ago	
qualcuna	Pronoun	7 months ago	
prova	Noun	7 months ago	
rimanere	Verb	7 months ago	
com'	Adverb	7 months ago	
chiamare	Verb	7 months ago	
operaio	Noun	8 months ago	
inghilterra	Proper noun	8 months ago	
scriverebbe	Verb	8 months ago	
problemi	Noun	8 months ago	
problema	Noun	8 months ago	
meccanismi	Noun	8 months ago	
ringraziare	Verb	8 months ago	
provando	Verb	8 months ago	
prenderai	Verb	8 months ago	
pensi	Verb	8 months ago	
emergenza	Noun	8 months ago	
prenderò	Verb	8 months ago	
moriate	Verb	8 months ago	
vantaggio	Noun	8 months ago	
liceo	Noun	8 months ago	
vantaggi	Noun	8 months ago	
unico	Adjective	8 months ago	
chiedano	Verb	8 months ago	
fotografiche	Adjective	8 months ago	
studi	Noun	8 months ago	
giudicare	Verb	8 months ago	
talmente	Adverb	8 months ago	
sorridere	Verb	8 months ago	
farlo	Pronoun	8 months ago	
petto	Noun	8 months ago	
campi	Noun	8 months ago	
là	Adverb	8 months ago	
seguiremo	Verb	8 months ago	
sufficienti	Adjective	8 months ago	
seguirà	Verb	8 months ago	
resterà	Verb	8 months ago	
resterò	Verb	8 months ago	
seguirò	Verb	8 months ago	
resteremo	Verb	8 months ago	
sufficiente	Adjective	8 months ago	
seguirai	Verb	8 months ago	
seguiranno	Verb	8 months ago	
fila	Noun	8 months ago	
giocattolo	Noun	8 months ago	
essenza	Noun	8 months ago	
occhi	Noun	8 months ago	
selvaggio	Adjective	8 months ago	
rivoluzionari	Adjective	8 months ago	
muscolo	Noun	8 months ago	
costante	Adjective	8 months ago	
europeo	Adjective	8 months ago	
europea	Adjective	8 months ago	
errori	Noun	8 months ago	
diploma	Noun	8 months ago	
lasciare	Verb	8 months ago	
vedrà	Verb	8 months ago	
perderai	Verb	8 months ago	
vedrò	Verb	8 months ago	
ruoli	Noun	8 months ago	
medicina	Noun	8 months ago	
statali	Adjective	8 months ago	
figli	Noun	8 months ago	
figlio	Noun	8 months ago	
figlia	Noun	8 months ago	
correndo	Verb	8 months ago	
capendo	Verb	8 months ago	
scriveremo	Verb	8 months ago	
compromessi	Noun	8 months ago	
compromesso	Noun	8 months ago	
piacerà	Verb	8 months ago	
scriverò	Verb	8 months ago	
scriverai	Verb	8 months ago	
inglese	Adjective	8 months ago	
inglesi	Adjective	8 months ago	
tenendo	Verb	8 months ago	
vivendo	Verb	8 months ago	
insomma	Adverb	8 months ago	
tavolo	Noun	8 months ago	
chiediamo	Verb	8 months ago	
venendo	Verb	8 months ago	
ambulanza	Noun	8 months ago	
rubare	Verb	8 months ago	
cantare	Verb	8 months ago	
gara	Noun	8 months ago	
dirgli	Pronoun	8 months ago	
spostare	Verb	8 months ago	
significati	Noun	8 months ago	
bellezza	Noun	8 months ago	
piangere	Verb	8 months ago	
deboli	Adjective	8 months ago	
debole	Adjective	8 months ago	
chiedeva	Verb	8 months ago	
indipendente	Adjective	8 months ago	
vivace	Adjective	8 months ago	
esecuzione	Noun	8 months ago	
etica	Adjective	8 months ago	
etico	Adjective	8 months ago	
numerose	Adjective	8 months ago	
spagnoli	Noun	8 months ago	
passaporto	Noun	8 months ago	
biondo	Adjective	8 months ago	
volo	Noun	8 months ago	
finale	Adjective	8 months ago	
rispetto	Noun	8 months ago	
francesi	Adjective	8 months ago	
francese	Adjective	8 months ago	
sullo	Preposition	8 months ago	
secondo	Preposition	8 months ago	
tiri	Verb	8 months ago	
gioia	Noun	8 months ago	
sappi	Verb	8 months ago	
parco	Noun	8 months ago	
usare	Verb	8 months ago	
colleghi	Noun	8 months ago	
stagione	Noun	8 months ago	
soleggiato	Adjective	8 months ago	
chiamerei	Verb	8 months ago	
ombra	Noun	8 months ago	
scriva	Verb	8 months ago	
crederai	Verb	8 months ago	
grassa	Adjective	8 months ago	
penne	Noun	8 months ago	
definitivi	Adjective	8 months ago	
possibile	Adjective	8 months ago	
penna	Noun	8 months ago	
pericolo	Noun	8 months ago	
segno	Noun	8 months ago	
pericoli	Noun	8 months ago	
metterà	Verb	8 months ago	
nono	Adjective	8 months ago	
nona	Adjective	8 months ago	
felici	Adjective	8 months ago	
esercizio	Noun	9 months ago	
avrebbe	Verb	9 months ago	
esercizi	Noun	9 months ago	
laurea	Noun	9 months ago	
istruzioni	Noun	9 months ago	
corso	Noun	9 months ago	
concetto	Noun	9 months ago	
professore	Noun	9 months ago	
commerciale	Adjective	9 months ago	
infantile	Adjective	9 months ago	
folla	Noun	9 months ago	
visitiamo	Verb	9 months ago	
spazzola	Noun	9 months ago	
balcone	Noun	9 months ago	
potei	Verb	9 months ago	
maniera	Noun	9 months ago	
disponibile	Adjective	9 months ago	
giovani	Noun	9 months ago	
disponibili	Adjective	9 months ago	
senti	Verb	9 months ago	
monete	Noun	9 months ago	
zona	Noun	9 months ago	
luna	Noun	9 months ago	
chiedere	Verb	9 months ago	
credesse	Verb	9 months ago	
sorriso	Noun	9 months ago	
credessimo	Verb	9 months ago	
aspettavo	Verb	9 months ago	
bosco	Noun	9 months ago	
emozioni	Noun	9 months ago	
frontiera	Noun	9 months ago	
tenemmo	Verb	9 months ago	
utile	Adjective	9 months ago	
generale	Adjective	9 months ago	
fisica	Adjective	9 months ago	
fisici	Adjective	9 months ago	
pensarono	Verb	9 months ago	
paesi	Noun	9 months ago	
regole	Noun	9 months ago	
metterla	Pronoun	9 months ago	
mettere	Verb	9 months ago	
diventassero	Verb	9 months ago	
governi	Noun	9 months ago	
governo	Noun	9 months ago	
diventasse	Verb	9 months ago	
finirebbe	Verb	9 months ago	
succede	Verb	9 months ago	
ce	Pronoun	9 months ago	
petizione	Noun	9 months ago	
tenda	Noun	9 months ago	
umana	Adjective	9 months ago	
invito	Noun	9 months ago	
traduzione	Noun	9 months ago	
speranze	Noun	9 months ago	
carcere	Noun	9 months ago	
secondi	Noun	9 months ago	
cambiando	Verb	9 months ago	
cartolina	Noun	9 months ago	
dica	Verb	9 months ago	
vendita	Noun	9 months ago	
suoniate	Verb	9 months ago	
pronto	Adjective	9 months ago	
pronta	Adjective	9 months ago	
maggio	Noun	9 months ago	
fantasma	Noun	9 months ago	
fantasmi	Noun	9 months ago	
mente	Noun	9 months ago	
menti	Noun	9 months ago	
nuvoloso	Adjective	9 months ago	
cancelli	Noun	9 months ago	
nere	Adjective	9 months ago	
vita	Noun	9 months ago	
simboli	Noun	9 months ago	
vite	Noun	9 months ago	
motocicletta	Noun	9 months ago	
moderni	Adjective	9 months ago	
viola	Adjective	9 months ago	
moderno	Adjective	9 months ago	
clinica	Noun	9 months ago	
comunicazioni	Noun	9 months ago	
anima	Noun	9 months ago	
riflessioni	Noun	9 months ago	
lunghe	Adjective	9 months ago	
lezioni	Noun	9 months ago	
intero	Adjective	9 months ago	
comune	Adjective	9 months ago	
pesante	Adjective	9 months ago	
sia	Verb	9 months ago	
benessere	Noun	9 months ago	
siano	Verb	9 months ago	
prodotto	Noun	9 months ago	
mettessi	Verb	9 months ago	
lesse	Verb	9 months ago	
giocò	Verb	9 months ago	
segreto	Noun	9 months ago	
oceano	Noun	9 months ago	
comoda	Adjective	9 months ago	
brillanti	Adjective	9 months ago	
feci	Verb	9 months ago	
capire	Verb	9 months ago	
sorpresi	Adjective	9 months ago	
giudici	Noun	9 months ago	
giudice	Noun	9 months ago	
arrivai	Verb	9 months ago	
allenatore	Noun	9 months ago	
organizzazione	Noun	9 months ago	
vedrebbe	Verb	9 months ago	
vedresti	Verb	9 months ago	
arriverai	Verb	9 months ago	
andrebbe	Verb	9 months ago	
andrebbero	Verb	9 months ago	
andresti	Verb	9 months ago	
spirito	Noun	9 months ago	
spiriti	Noun	9 months ago	
guida	Noun	9 months ago	
cittadino	Noun	9 months ago	
effetti	Noun	9 months ago	
effetto	Noun	9 months ago	
vittima	Noun	9 months ago	
operaia	Noun	9 months ago	
morissi	Verb	9 months ago	
documento	Noun	9 months ago	
pagina	Noun	9 months ago	
piacesse	Verb	9 months ago	
peggiore	Adjective	9 months ago	
voti	Noun	9 months ago	
piacere	Noun	9 months ago	
guarderò	Verb	9 months ago	
collega	Noun	9 months ago	
guarderanno	Verb	9 months ago	
guarderai	Verb	9 months ago	
parlamento	Noun	9 months ago	
parlamenti	Noun	9 months ago	
costruirebbe	Verb	9 months ago	
chiamereste	Verb	9 months ago	
costruirei	Verb	9 months ago	
costruiremo	Verb	9 months ago	
democratica	Adjective	9 months ago	
democratico	Adjective	9 months ago	
stadio	Noun	9 months ago	
cuore	Noun	9 months ago	
pasticceria	Noun	9 months ago	
capivo	Verb	9 months ago	
memoria	Noun	9 months ago	
visione	Noun	9 months ago	
vorrà	Verb	9 months ago	
probabile	Adjective	9 months ago	
soleggiata	Adjective	9 months ago	
soleggiate	Adjective	9 months ago	
corona	Noun	9 months ago	
trasformazione	Noun	9 months ago	
popolare	Adjective	9 months ago	
alto	Adjective	9 months ago	
alti	Adjective	9 months ago	
necessario	Adjective	9 months ago	
necessari	Adjective	9 months ago	
alta	Adjective	9 months ago	
meditazioni	Noun	9 months ago	
rivoluzione	Noun	9 months ago	
artista	Noun	9 months ago	
provai	Verb	9 months ago	
vada	Verb	9 months ago	
artisti	Noun	9 months ago	
diventerebbe	Verb	9 months ago	
conseguenza	Noun	9 months ago	
personale	Adjective	9 months ago	
ambasciatore	Noun	9 months ago	
uguale	Adjective	9 months ago	
dio	Noun	9 months ago	
dei	Noun	9 months ago	
dirigenza	Noun	9 months ago	
aspettereste	Verb	9 months ago	
complesso	Noun	9 months ago	
presidenza	Noun	10 months ago	
piante	Noun	10 months ago	
camicia	Noun	10 months ago	
camicie	Noun	10 months ago	
noiosa	Adjective	10 months ago	
alunni	Noun	10 months ago	
appetito	Noun	10 months ago	
leggeresti	Verb	10 months ago	
leggerei	Verb	10 months ago	
magre	Adjective	10 months ago	
magra	Adjective	10 months ago	
collezione	Noun	10 months ago	
pista	Noun	10 months ago	
divisione	Noun	10 months ago	
diede	Verb	10 months ago	
vidi	Verb	10 months ago	
chiese	Verb	10 months ago	
chiedemmo	Verb	10 months ago	
videro	Verb	10 months ago	
diventò	Verb	10 months ago	
parlammo	Verb	10 months ago	
usarono	Verb	10 months ago	
ricordò	Verb	10 months ago	
capii	Verb	10 months ago	
palazzi	Noun	10 months ago	
credevo	Verb	10 months ago	
credeva	Verb	10 months ago	
andai	Verb	10 months ago	
novembre	Noun	10 months ago	
costruiate	Verb	10 months ago	
costruiscano	Verb	10 months ago	
ultima	Adjective	10 months ago	
ultimi	Adjective	10 months ago	
portano	Verb	10 months ago	
porto	Verb	10 months ago	
automobile	Noun	10 months ago	
automobili	Noun	10 months ago	
vorrei	Verb	10 months ago	
farà	Verb	10 months ago	
farai	Verb	10 months ago	
politico	Adjective	10 months ago	
cambiassi	Verb	10 months ago	
politica	Adjective	10 months ago	
aprissi	Verb	10 months ago	
politici	Adjective	10 months ago	
seguissero	Verb	10 months ago	
fidanzata	Noun	10 months ago	
fidanzato	Noun	10 months ago	
fidanzate	Noun	10 months ago	
rimanete	Verb	10 months ago	
rimanga	Verb	10 months ago	
leggere	Adjective	10 months ago	
lenta	Adjective	10 months ago	
lento	Adjective	10 months ago	
finanziamento	Noun	10 months ago	
venditori	Noun	10 months ago	
disegno	Noun	10 months ago	
arriveremo	Verb	10 months ago	
venditore	Noun	10 months ago	
internazionali	Adjective	10 months ago	
matrimonio	Noun	10 months ago	
bagnati	Adjective	10 months ago	
postini	Noun	10 months ago	
attraverso	Verb	10 months ago	
geografia	Noun	10 months ago	
dollari	Noun	10 months ago	
risorse	Noun	10 months ago	
principale	Adjective	10 months ago	
angelo	Noun	10 months ago	
sala	Noun	10 months ago	
faceva	Verb	10 months ago	
facevano	Verb	10 months ago	
diritte	Adjective	10 months ago	
diritta	Adjective	10 months ago	
potemmo	Verb	10 months ago	
violino	Noun	10 months ago	
leggeremo	Verb	10 months ago	
odore	Noun	10 months ago	
grande	Adjective	10 months ago	
mettessero	Verb	10 months ago	
entrerebbe	Verb	10 months ago	
mettesse	Verb	10 months ago	
viaggia	Verb	10 months ago	
viaggiate	Verb	10 months ago	
piange	Verb	10 months ago	
viaggiamo	Verb	10 months ago	
viaggio	Verb	10 months ago	
viaggiano	Verb	10 months ago	
processi	Noun	10 months ago	
lavorasse	Verb	10 months ago	
indicassi	Verb	10 months ago	
aspettassero	Verb	10 months ago	
vedessero	Verb	10 months ago	
aspettassimo	Verb	10 months ago	
re	Noun	10 months ago	
regina	Noun	10 months ago	
perdessimo	Verb	10 months ago	
proprietario	Noun	10 months ago	
giocheranno	Verb	10 months ago	
giocherò	Verb	10 months ago	
giocherà	Verb	10 months ago	
dolore	Noun	10 months ago	
dolori	Noun	10 months ago	
vedrete	Verb	10 months ago	
esperienza	Noun	10 months ago	
esperienze	Noun	10 months ago	
morte	Noun	10 months ago	
morti	Noun	10 months ago	
costosa	Adjective	10 months ago	
sciampo	Noun	10 months ago	
frigoriferi	Noun	10 months ago	
contratto	Noun	10 months ago	
scale	Noun	10 months ago	
mancano	Verb	10 months ago	
agricoltura	Noun	10 months ago	
rimangono	Verb	10 months ago	
ritorno	Noun	10 months ago	
desiderio	Noun	10 months ago	
categoria	Noun	10 months ago	
categorie	Noun	10 months ago	
carta	Noun	10 months ago	
montagne	Noun	10 months ago	
lampada	Noun	10 months ago	
alcuni	Determiner	10 months ago	
alcune	Determiner	10 months ago	
alcuna	Determiner	10 months ago	
occhiali	Noun	10 months ago	
muro	Noun	10 months ago	
dura	Verb	10 months ago	
muri	Noun	10 months ago	
grido	Noun	10 months ago	
terra	Noun	10 months ago	
diverse	Adjective	10 months ago	
diversa	Adjective	10 months ago	
diversi	Adjective	10 months ago	
lenzuola	Noun	10 months ago	
quinta	Adjective	10 months ago	
quinto	Adjective	10 months ago	
leggerebbe	Verb	10 months ago	
centro	Noun	10 months ago	
chiamasse	Verb	10 months ago	
roccia	Noun	10 months ago	
pensiero	Noun	10 months ago	
doccia	Noun	10 months ago	
docce	Noun	10 months ago	
medicine	Noun	10 months ago	
sesto	Adjective	10 months ago	
seguirono	Verb	10 months ago	
aspettarono	Verb	10 months ago	
guardò	Verb	10 months ago	
sentirebbe	Verb	10 months ago	
metodi	Noun	10 months ago	
finisca	Verb	10 months ago	
laboratorio	Noun	10 months ago	
legga	Verb	10 months ago	
semestre	Noun	10 months ago	
scoperta	Noun	10 months ago	
diano	Verb	10 months ago	
ricordi	Verb	10 months ago	
sappia	Verb	10 months ago	
camere	Noun	10 months ago	
camera	Noun	10 months ago	
classica	Adjective	10 months ago	
sviluppo	Noun	10 months ago	
gioco	Noun	10 months ago	
giochi	Noun	10 months ago	
visse	Verb	10 months ago	
lavorò	Verb	10 months ago	
ricordai	Verb	10 months ago	
passammo	Verb	10 months ago	
lasciò	Verb	10 months ago	
sentii	Verb	10 months ago	
prese	Verb	10 months ago	
pensammo	Verb	10 months ago	
conobbi	Verb	10 months ago	
vide	Verb	10 months ago	
concorrenza	Noun	10 months ago	
sonno	Noun	10 months ago	
sensazione	Noun	10 months ago	
chiederò	Verb	10 months ago	
aspetterà	Verb	10 months ago	
aspetteremo	Verb	10 months ago	
aspetterai	Verb	10 months ago	
andremo	Verb	10 months ago	
arriveranno	Verb	10 months ago	
aspetterò	Verb	10 months ago	
aspetteranno	Verb	10 months ago	
andrò	Verb	10 months ago	
morirà	Verb	10 months ago	
perderò	Verb	10 months ago	
cambieremo	Verb	10 months ago	
vedremo	Verb	10 months ago	
avranno	Verb	10 months ago	
vedrai	Verb	10 months ago	
decidesse	Verb	10 months ago	
scriverà	Verb	10 months ago	
fasi	Noun	10 months ago	
fase	Noun	10 months ago	
educazione	Noun	10 months ago	
ricordasse	Verb	10 months ago	
cura	Noun	10 months ago	
cugino	Noun	10 months ago	
esami	Noun	10 months ago	
torneo	Noun	10 months ago	
cugini	Noun	10 months ago	
esame	Noun	10 months ago	
rischi	Noun	10 months ago	
profondo	Adjective	10 months ago	
capiva	Verb	10 months ago	
tradizionale	Adjective	10 months ago	
ebbe	Verb	10 months ago	
altezza	Noun	10 months ago	
sforzo	Noun	10 months ago	
volo	Verb	10 months ago	
sforzi	Noun	10 months ago	
comportamento	Noun	10 months ago	
morti	Adjective	10 months ago	
morta	Adjective	10 months ago	
pagliaccio	Noun	10 months ago	
visioni	Noun	10 months ago	
elettriche	Adjective	10 months ago	
regali	Noun	10 months ago	
logica	Adjective	10 months ago	
logico	Adjective	10 months ago	
gentile	Adjective	10 months ago	
volta	Noun	10 months ago	
volte	Noun	10 months ago	
campione	Noun	10 months ago	
calendario	Noun	10 months ago	
culture	Noun	10 months ago	
cultura	Noun	10 months ago	
muscoli	Noun	10 months ago	
palestra	Noun	10 months ago	
soddisfazioni	Noun	10 months ago	
sentimento	Noun	10 months ago	
soddisfazione	Noun	10 months ago	
perfetti	Adjective	10 months ago	
perfetta	Adjective	10 months ago	
darai	Verb	11 months ago	
risponderanno	Verb	11 months ago	
offriranno	Verb	11 months ago	
crederà	Verb	11 months ago	
lascia	Verb	11 months ago	
rispondi	Verb	11 months ago	
lasciamo	Verb	11 months ago	
manda	Verb	11 months ago	
rispondo	Verb	11 months ago	
rispondono	Verb	11 months ago	
spazio	Noun	11 months ago	
mondo	Noun	11 months ago	
ragione	Noun	11 months ago	
crescita	Noun	11 months ago	
movimenti	Noun	11 months ago	
forze	Noun	11 months ago	
forza	Noun	11 months ago	
personaggio	Noun	11 months ago	
sicurezza	Noun	11 months ago	
danni	Noun	11 months ago	
presentazione	Noun	11 months ago	
decisione	Noun	11 months ago	
decisioni	Noun	11 months ago	
passava	Verb	11 months ago	
andava	Verb	11 months ago	
piacerebbe	Verb	11 months ago	
ritorni	Noun	11 months ago	
vedevamo	Verb	11 months ago	
stessa	Adjective	11 months ago	
provavamo	Verb	11 months ago	
cinese	Noun	11 months ago	
spagnolo	Noun	11 months ago	
argentino	Adjective	11 months ago	
turismo	Noun	11 months ago	
argentini	Adjective	11 months ago	
visite	Noun	11 months ago	
argentina	Adjective	11 months ago	
portoghese	Adjective	11 months ago	
trasporti	Noun	11 months ago	
parti	Verb	11 months ago	
segretaria	Noun	11 months ago	
bassi	Adjective	11 months ago	
pareti	Noun	11 months ago	
sentivi	Verb	11 months ago	
chiamava	Verb	11 months ago	
sentivamo	Verb	11 months ago	
capisca	Verb	11 months ago	
dicessero	Verb	11 months ago	
capissi	Verb	11 months ago	
fondo	Noun	11 months ago	
sapessi	Verb	11 months ago	
inizi	Noun	11 months ago	
inizio	Noun	11 months ago	
preferisci	Verb	11 months ago	
preferisce	Verb	11 months ago	
pagella	Noun	11 months ago	
sinistra	Noun	11 months ago	
dizionario	Noun	11 months ago	
studente	Noun	11 months ago	
scuole	Noun	11 months ago	
frase	Noun	11 months ago	
studenti	Noun	11 months ago	
livelli	Noun	11 months ago	
scuola	Noun	11 months ago	
livello	Noun	11 months ago	
vivi	Verb	11 months ago	
viva	Verb	11 months ago	
antica	Adjective	11 months ago	
fondamentale	Adjective	11 months ago	
antico	Adjective	11 months ago	
negativa	Adjective	11 months ago	
semplice	Adjective	11 months ago	
efficaci	Adjective	11 months ago	
negativo	Adjective	11 months ago	
attenti	Adjective	11 months ago	
differente	Adjective	11 months ago	
differenti	Adjective	11 months ago	
veloce	Adjective	11 months ago	
grave	Adjective	11 months ago	
avanzato	Adjective	11 months ago	
avanzata	Adjective	11 months ago	
settima	Adjective	11 months ago	
settimo	Adjective	11 months ago	
carino	Adjective	11 months ago	
sorridi	Verb	11 months ago	
arrostiamo	Verb	11 months ago	
insegna	Verb	11 months ago	
migliora	Verb	11 months ago	
insegni	Verb	11 months ago	
insegno	Verb	11 months ago	
arrostisci	Verb	11 months ago	
arrostisco	Verb	11 months ago	
sorride	Verb	11 months ago	
riposo	Verb	11 months ago	
indosso	Verb	11 months ago	
riempie	Verb	11 months ago	
riposiamo	Verb	11 months ago	
abbassa	Verb	11 months ago	
riempiono	Verb	11 months ago	
pianifica	Verb	11 months ago	
visita	Verb	11 months ago	
pianifichi	Verb	11 months ago	
indossa	Verb	11 months ago	
riposa	Verb	11 months ago	
pianifichiamo	Verb	11 months ago	
ospite	Noun	11 months ago	
specchio	Noun	11 months ago	
direttori	Noun	11 months ago	
direttore	Noun	11 months ago	
specchi	Noun	11 months ago	
zone	Noun	11 months ago	
vengano	Verb	11 months ago	
venga	Verb	11 months ago	
usino	Verb	11 months ago	
arriverebbe	Verb	11 months ago	
indicherebbe	Verb	11 months ago	
futura	Adjective	11 months ago	
terzo	Adjective	11 months ago	
saprò	Verb	11 months ago	
sapranno	Verb	11 months ago	
saprà	Verb	11 months ago	
saprete	Verb	11 months ago	
ottavo	Adjective	11 months ago	
cinquant'	Numeral	11 months ago	
cinquanta	Numeral	11 months ago	
settimane	Noun	11 months ago	
parli	Verb	11 months ago	
costruisca	Verb	11 months ago	
ultimo	Adjective	11 months ago	
stazione	Noun	11 months ago	
bagno	Noun	11 months ago	
corpi	Noun	11 months ago	
chiave	Noun	11 months ago	
rosa	Adjective	11 months ago	
coppia	Noun	11 months ago	
spiega	Verb	11 months ago	
cambia	Verb	11 months ago	
scusate	Verb	11 months ago	
nervose	Adjective	11 months ago	
nervosa	Adjective	11 months ago	
sogni	Noun	11 months ago	
nervoso	Adjective	11 months ago	
sogno	Noun	11 months ago	
nervosi	Adjective	11 months ago	
appartamento	Noun	11 months ago	
pericolosa	Adjective	11 months ago	
economico	Adjective	11 months ago	
capace	Adjective	11 months ago	
entrino	Verb	11 months ago	
lunga	Adjective	11 months ago	
vecchio	Adjective	11 months ago	
vecchie	Adjective	11 months ago	
cari	Adjective	11 months ago	
difficile	Adjective	11 months ago	
grossi	Adjective	11 months ago	
tavola	Noun	11 months ago	
tappeti	Noun	11 months ago	
tappeto	Noun	11 months ago	
cognomi	Noun	11 months ago	
fratello	Noun	11 months ago	
secoli	Noun	11 months ago	
secolo	Noun	11 months ago	
sera	Noun	11 months ago	
voli	Noun	11 months ago	
sarei	Verb	11 months ago	
arriveresti	Verb	11 months ago	
sarebbe	Verb	11 months ago	
prendereste	Verb	11 months ago	
risponderei	Verb	11 months ago	
ricorderebbe	Verb	11 months ago	
arriverei	Verb	11 months ago	
risponderebbe	Verb	11 months ago	
vedrei	Verb	11 months ago	
punti	Noun	11 months ago	
punto	Noun	11 months ago	
chiami	Verb	11 months ago	
voglio	Verb	11 months ago	
vogliamo	Verb	11 months ago	
vuoi	Verb	11 months ago	
pianta	Noun	11 months ago	
esperti	Noun	11 months ago	
passeresti	Verb	11 months ago	
verremmo	Verb	11 months ago	
paziente	Noun	11 months ago	
guardava	Verb	11 months ago	
costruiva	Verb	11 months ago	
entravano	Verb	11 months ago	
apriva	Verb	11 months ago	
usava	Verb	11 months ago	
entrava	Verb	11 months ago	
aprivano	Verb	11 months ago	
provava	Verb	11 months ago	
provavo	Verb	11 months ago	
perdevamo	Verb	11 months ago	
aprivo	Verb	11 months ago	
ricevo	Verb	12 months ago	
fermano	Verb	12 months ago	
significa	Verb	12 months ago	
incontra	Verb	12 months ago	
attraversano	Verb	12 months ago	
fermo	Verb	12 months ago	
gira	Verb	12 months ago	
girate	Verb	12 months ago	
riceve	Verb	12 months ago	
aspettate	Verb	12 months ago	
divento	Verb	12 months ago	
idraulici	Noun	12 months ago	
idraulico	Noun	12 months ago	
lavorerebbe	Verb	12 months ago	
lavorerebbero	Verb	12 months ago	
darei	Verb	12 months ago	
prenderebbero	Verb	12 months ago	
uniresti	Verb	12 months ago	
liberazione	Noun	1 year ago	
offrirebbero	Verb	1 year ago	
offrirebbe	Verb	1 year ago	
tenga	Verb	1 year ago	
userebbe	Verb	1 year ago	
farei	Verb	1 year ago	
processo	Noun	1 year ago	
metta	Verb	1 year ago	
decideranno	Verb	1 year ago	
finirà	Verb	1 year ago	
indicherà	Verb	1 year ago	
proverò	Verb	1 year ago	
morte	Adjective	1 year ago	
conoscano	Verb	1 year ago	
amicizia	Noun	1 year ago	
unirei	Verb	1 year ago	
romanzi	Noun	1 year ago	
aprile	Noun	1 year ago	
passo	Verb	1 year ago	
dovevo	Verb	1 year ago	
potrò	Verb	1 year ago	
lasceresti	Verb	1 year ago	
esperto	Noun	1 year ago	
pratica	Noun	1 year ago	
cambio	Noun	1 year ago	
contenta	Adjective	1 year ago	
tenevo	Verb	1 year ago	
numero	Noun	1 year ago	
valigie	Noun	1 year ago	
eccellenti	Adjective	1 year ago	
eccellente	Adjective	1 year ago	
leggevano	Verb	1 year ago	
profonda	Adjective	1 year ago	
chiamerai	Verb	1 year ago	
porti	Verb	1 year ago	
cancello	Noun	1 year ago	
trovate	Verb	1 year ago	
maglione	Noun	1 year ago	
cintura	Noun	1 year ago	
ruolo	Noun	1 year ago	
costruiranno	Verb	1 year ago	
risponderemo	Verb	1 year ago	
penseremo	Verb	1 year ago	
risponderà	Verb	1 year ago	
penserai	Verb	1 year ago	
penserò	Verb	1 year ago	
penserà	Verb	1 year ago	
indicherò	Verb	1 year ago	
succederà	Verb	1 year ago	
abbia	Verb	1 year ago	
bacio	Noun	1 year ago	
baci	Noun	1 year ago	
intellettuale	Adjective	1 year ago	
intellettuali	Adjective	1 year ago	
dottoresse	Noun	1 year ago	
aprirai	Verb	1 year ago	
frigorifero	Noun	1 year ago	
nazionale	Adjective	1 year ago	
muore	Verb	1 year ago	
sciampi	Noun	1 year ago	
daranno	Verb	1 year ago	
ricorderà	Verb	1 year ago	
giocatore	Noun	1 year ago	
giocatori	Noun	1 year ago	
mese	Noun	1 year ago	
scala	Noun	1 year ago	
libreria	Noun	1 year ago	
tetto	Noun	1 year ago	
descrive	Verb	1 year ago	
importante	Adjective	1 year ago	
internazionale	Adjective	1 year ago	
peggiori	Adjective	1 year ago	
accendo	Verb	1 year ago	
proverete	Verb	1 year ago	
credono	Verb	1 year ago	
arriverà	Verb	1 year ago	
decideremo	Verb	1 year ago	
aprirà	Verb	1 year ago	
apriremo	Verb	1 year ago	
aprirò	Verb	1 year ago	
cresce	Verb	1 year ago	
tenete	Verb	1 year ago	
tengono	Verb	1 year ago	
grigie	Adjective	1 year ago	
farò	Verb	1 year ago	
suonerete	Verb	1 year ago	
chiamerò	Verb	1 year ago	
costruirà	Verb	1 year ago	
prenotiamo	Verb	1 year ago	
ruba	Verb	1 year ago	
prenotano	Verb	1 year ago	
pagelle	Noun	1 year ago	
entreranno	Verb	1 year ago	
vivranno	Verb	1 year ago	
chiameranno	Verb	1 year ago	
manco	Verb	1 year ago	
manca	Verb	1 year ago	
costruiamo	Verb	1 year ago	
costruisci	Verb	1 year ago	
arrabbiata	Adjective	1 year ago	
darò	Verb	1 year ago	
conosciamo	Verb	1 year ago	
conosco	Verb	1 year ago	
turista	Noun	1 year ago	
decideva	Verb	1 year ago	
mezzo	Noun	1 year ago	
cattivo	Adjective	1 year ago	
venite	Verb	1 year ago	
cattiva	Adjective	1 year ago	
prende	Verb	1 year ago	
caro	Adjective	1 year ago	
pericolosi	Adjective	1 year ago	
pressione	Noun	1 year ago	
sedia	Noun	1 year ago	
popolari	Adjective	1 year ago	
pagine	Noun	1 year ago	
protezione	Noun	1 year ago	
potenziale	Adjective	1 year ago	
rivoluzionario	Adjective	1 year ago	
giocavano	Verb	1 year ago	
giocava	Verb	1 year ago	
normale	Adjective	1 year ago	
giugno	Noun	1 year ago	
intelligente	Adjective	1 year ago	
puliti	Adjective	1 year ago	
bagnate	Adjective	1 year ago	
bagnato	Adjective	1 year ago	
pulita	Adjective	1 year ago	
brutti	Adjective	1 year ago	
stanza	Noun	1 year ago	
fermata	Noun	1 year ago	
elettrica	Adjective	1 year ago	
serie	Adjective	1 year ago	
dizionari	Noun	1 year ago	
computer	Noun	1 year ago	
attenta	Adjective	1 year ago	
attento	Adjective	1 year ago	
progetto	Noun	1 year ago	
caldo	Adjective	1 year ago	
caldi	Adjective	1 year ago	
avventure	Noun	1 year ago	
aula	Noun	1 year ago	
buona	Adjective	1 year ago	
sta	Verb	1 year ago	
poca	Determiner	1 year ago	
pochi	Determiner	1 year ago	
doppio	Noun	1 year ago	
cerco	Verb	1 year ago	
pensano	Verb	1 year ago	
pensa	Verb	1 year ago	
pura	Adjective	1 year ago	
puro	Adjective	1 year ago	
odio	Noun	1 year ago	
istituto	Noun	1 year ago	
costruzioni	Noun	1 year ago	
istituti	Noun	1 year ago	
costruzione	Noun	1 year ago	
siede	Verb	1 year ago	
porta	Verb	1 year ago	
frequente	Adjective	1 year ago	
frequenti	Adjective	1 year ago	
passiamo	Verb	1 year ago	
sentimenti	Noun	1 year ago	
personaggi	Noun	1 year ago	
maggioranza	Noun	1 year ago	
decennio	Noun	1 year ago	
generazioni	Noun	1 year ago	
generazione	Noun	1 year ago	
chilometro	Noun	1 year ago	
antichi	Adjective	1 year ago	
umani	Adjective	1 year ago	
crescono	Verb	1 year ago	
quotidiano	Adjective	1 year ago	
obiettivo	Noun	1 year ago	
cerchi	Verb	1 year ago	
ritardo	Noun	1 year ago	
professoressa	Noun	1 year ago	
errore	Noun	1 year ago	
lasciate	Verb	1 year ago	
recente	Adjective	1 year ago	
recenti	Adjective	1 year ago	
efficace	Adjective	1 year ago	
vendo	Verb	1 year ago	
notte	Noun	1 year ago	
scusi	Verb	1 year ago	
corro	Verb	1 year ago	
corriamo	Verb	1 year ago	
corre	Verb	1 year ago	
corri	Verb	1 year ago	
corrono	Verb	1 year ago	
liberi	Adjective	1 year ago	
alte	Adjective	1 year ago	
libero	Adjective	1 year ago	
sicura	Adjective	1 year ago	
calda	Adjective	1 year ago	
seggiola	Noun	1 year ago	
mogli	Noun	1 year ago	
guardiamo	Verb	1 year ago	
guardate	Verb	1 year ago	
sa	Verb	1 year ago	
entra	Verb	1 year ago	
sappiamo	Verb	1 year ago	
sai	Verb	1 year ago	
so	Verb	1 year ago	
professionali	Adjective	1 year ago	
stanche	Adjective	1 year ago	
stanco	Adjective	1 year ago	
pubblica	Adjective	1 year ago	
negative	Adjective	1 year ago	
porta	Noun	1 year ago	
cammina	Verb	1 year ago	
chiusa	Adjective	1 year ago	
matita	Noun	1 year ago	
desideri	Noun	1 year ago	
regalo	Noun	1 year ago	
sentiva	Verb	1 year ago	
unite	Verb	1 year ago	
chiavi	Noun	1 year ago	
coperta	Noun	1 year ago	
feste	Noun	1 year ago	
dice	Verb	1 year ago	
tenevano	Verb	1 year ago	
obiettivi	Noun	1 year ago	
ragioni	Noun	1 year ago	
globale	Adjective	1 year ago	
amo	Verb	1 year ago	
ami	Verb	1 year ago	
bravo	Adjective	1 year ago	
settimana	Noun	1 year ago	
poveri	Adjective	1 year ago	
povera	Adjective	1 year ago	
eravamo	Verb	1 year ago	
morivano	Verb	1 year ago	
trovava	Verb	1 year ago	
leggevo	Verb	1 year ago	
era	Verb	1 year ago	
trovavamo	Verb	1 year ago	
ero	Verb	1 year ago	
moriva	Verb	1 year ago	
leggeva	Verb	1 year ago	
trovavano	Verb	1 year ago	
guidiamo	Verb	1 year ago	
volevo	Verb	1 year ago	
voleva	Verb	1 year ago	
prendono	Verb	1 year ago	
prossimo	Adjective	1 year ago	
nome	Noun	1 year ago	
fratelli	Noun	1 year ago	
minuti	Noun	1 year ago	
minuto	Noun	1 year ago	
gratuito	Adjective	1 year ago	
gratuita	Adjective	1 year ago	
cattivi	Adjective	1 year ago	
giovani	Adjective	1 year ago	
giovane	Adjective	1 year ago	
libri	Noun	1 year ago	
usa	Verb	1 year ago	
brucia	Verb	1 year ago	
leggera	Adjective	1 year ago	
indipendenti	Adjective	1 year ago	
poco	Determiner	1 year ago	
semplici	Adjective	1 year ago	
sediamo	Verb	1 year ago	
dormiamo	Verb	1 year ago	
dormono	Verb	1 year ago	
dorme	Verb	1 year ago	
dormo	Verb	1 year ago	
colpisci	Verb	1 year ago	
colpiamo	Verb	1 year ago	
colpisco	Verb	1 year ago	
chiudete	Verb	1 year ago	
periodo	Noun	1 year ago	
arrivano	Verb	1 year ago	
nuota	Verb	1 year ago	
giocano	Verb	1 year ago	
indica	Verb	1 year ago	
gioca	Verb	1 year ago	
gioco	Verb	1 year ago	
sceglie	Verb	1 year ago	
posti	Noun	1 year ago	
posto	Noun	1 year ago	
friggiamo	Verb	1 year ago	
frigge	Verb	1 year ago	
spingo	Verb	1 year ago	
friggi	Verb	1 year ago	
coltiva	Verb	1 year ago	
svuotano	Verb	1 year ago	
lavo	Verb	1 year ago	
svuoti	Verb	1 year ago	
lava	Verb	1 year ago	
coltivo	Verb	1 year ago	
coltivano	Verb	1 year ago	
falliscono	Verb	1 year ago	
riempiamo	Verb	1 year ago	
riempi	Verb	1 year ago	
fallisci	Verb	1 year ago	
tante	Determiner	1 year ago	
tanta	Determiner	1 year ago	
tanto	Determiner	1 year ago	
mattina	Noun	1 year ago	
genitori	Noun	1 year ago	
molti	Determiner	1 year ago	
molte	Determiner	1 year ago	
molto	Determiner	1 year ago	
nuovo	Adjective	1 year ago	
segue	Verb	1 year ago	
dimentica	Verb	1 year ago	
dimentichiamo	Verb	1 year ago	
persona	Noun	1 year ago	
forma	Noun	1 year ago	
sento	Verb	1 year ago	
passano	Verb	1 year ago	
simpatica	Adjective	1 year ago	
compra	Verb	1 year ago	
cucina	Verb	1 year ago	
compro	Verb	1 year ago	
suona	Verb	1 year ago	
signori	Noun	1 year ago	
aspetto	Verb	1 year ago	
aspettiamo	Verb	1 year ago	
dico	Verb	1 year ago	
cucino	Verb	1 year ago	
aggiungi	Verb	1 year ago	
ritorna	Verb	1 year ago	
aggiungo	Verb	1 year ago	
ritorni	Verb	1 year ago	
aggiunge	Verb	1 year ago	
compriamo	Verb	1 year ago	
pesanti	Adjective	1 year ago	
famiglia	Noun	1 year ago	
piccola	Adjective	1 year ago	
piccoli	Adjective	1 year ago	
piccolo	Adjective	1 year ago	
potete	Verb	1 year ago	
possiamo	Verb	1 year ago	
può	Verb	1 year ago	
puoi	Verb	1 year ago	
posso	Verb	1 year ago	
scegli	Verb	1 year ago	
macchina	Noun	1 year ago	
cappelli	Noun	1 year ago	
tempo	Noun	1 year ago	
nonni	Noun	1 year ago	
parla	Verb	1 year ago	
chiede	Verb	1 year ago	
studio	Verb	1 year ago	
vendono	Verb	1 year ago	
momento	Noun	1 year ago	
nuovi	Adjective	1 year ago	
nuove	Adjective	1 year ago	
nuova	Adjective	1 year ago	
controllo	Verb	1 year ago	
indichi	Verb	1 year ago	
ama	Verb	1 year ago	
buon	Adjective	1 year ago	
vecchia	Adjective	1 year ago	
giocattoli	Noun	1 year ago	
figlie	Noun	1 year ago	
moriamo	Verb	1 year ago	
chiamo	Verb	1 year ago	
crediamo	Verb	1 year ago	
credo	Verb	1 year ago	
capisco	Verb	1 year ago	
arriva	Verb	1 year ago	
sente	Verb	1 year ago	
capisce	Verb	1 year ago	
credi	Verb	1 year ago	
capisci	Verb	1 year ago	
mangiano	Verb	1 year ago	
piace	Verb	1 year ago	
uso	Verb	1 year ago	
lavoro	Verb	1 year ago	
ricordo	Verb	1 year ago	
troviamo	Verb	1 year ago	
piacciono	Verb	1 year ago	
va	Verb	1 year ago	
mangiate	Verb	1 year ago	
hai	Verb	1 year ago	
hanno	Verb	1 year ago	
pantaloni	Noun	1 year ago	
mangiamo	Verb	1 year ago	
